g_dict=`
the|этот
be|быть
am|являюсь
are|являются
aren't|не-являются
been|был
being|существование
beings|существа
is|является
isn't|не-является
was|был
wasn't|не-был
were|были
weren't|не-были
and|и
of|из
to|к
a|некий, один, любой, какой-то
an|некий
in|в
have|иметь
had|имел
hadn't|не-имел
has|имеет
hasn't|не-имеет
haven't|не-имеют
having|имея
it|это
its|его
you|ты
your|твой
yours|твоё
he|он
him|ему
his|его
for|для
they|они
their|их
theirs|их,ихние
them|их,им
not|не,нет
that|тот
those|те
we|мы
our|наш
ours|наш
us|нас
on|на
with|с
this|это,этот
these|эти
I|Я
me|мне
my|мой
do|делать
did|делал
didn't|не-сделал
does|делает
doesn't|не-делает
doing|делает
don't|не-делать
done|сделанный
as|как,так-как,за
at|в,у,на
she|она
her|её
hers|её,еёный
but|но
buts|но?
from|из,от
by|по,у,при,через,к
will|будет 2.воля,желание
willed|волевой
willing|готовый
won't|не-будет
or|или
say|сказать
said|сказал
saying|говоря
sayings|поговорки
says|говорит
go|идти
goes|идет
going|идущий
gone|ушел
gonna|собираюсь
went|шел
so|так-что,так
all|все
if|если
ifs|если
one|один
ones|те
would|будет,бы
wouldn't|не-будет
about|о
can|может
can't|не-мочь
cannot|не-может
which|который
there|там
know|знать
knew|знал
knowing|зная
known|известный
knows|знает
more|больше,более
get|получить,получать
gets|получает
getting|получающий
got|получил
gotta|должен
gotten|получил
who|кто
whom|кому
whose|чей
like|любить,нравиться 2.похожий,как
liked|понравилось
likes|нравится
liking|нравится
when|​​когда
think|думать,мыслить
thinking|думая
thinks|думает
thought|мысль
thoughts|мысли
make|сделать,делать,изготавливать
made|сделал
makes|делает
making|изготовление
time|время
timed|рассчитанный-по-времени
times|раз
timing|время
see|видеть
saw|видел,пила
seeing|видя
seen|видимый
sees|видит
what|что
up|вверх
upped|повышенный
upping|повышение
ups|UPS
some|некоторый,некоторое-количество
other|другой
others|другие
out|вне,снаружи,из,вон
outed|выведено,изгнан
outing|вылазка
outings|вылазки
outs|опозиция? недостатки,выходы
good|хорошо,хороший
people|люди,народ
peopled|населенный
peoples|народы
peopling|заселение,заполнение (пространства людьми)
year|год
years|годы
take|взять,брать
taken|взятый
takes|занимает,берёт
taking|принимая
took|взял
no|нет
well|хорошо 2.колодец
welled|изливаться,бить-ключом
welling|истекание,выздоровление
wells|скважины
because|потому-что
very|очень
just|только,просто,точно 2.справедливый,беспристрастный
come|приходить
came|пришел
comes|приходит
coming|приходящий
could|мог-бы,мог
coulda|мог-бы
couldn't|не-мог
work|работа,работать
worked|работал
working|работающий
workings|работы
works|работает
use|использовать
used|использовал
uses|использует
using|с-использованием
than|чем
now|теперь,сейчас
then|тогда,затем
also|также
into|в
only|только
look|взгляд,выглядеть,смотреть
looked|посмотрел
looking|смотрящий
looks|выглядит
want|хочу,хотеть
wanna|хочу
wanted|в-розыске
wanting|желая
wants|хочет
give|дать,давать
gave|отдал
given|данный
gives|дает
giving|давая
first|первый
firsts|первые
new|новый
newer|новее
newest|новейший
way|путь,способ
ways|способы
find|находить,найти
finding|находка
findings|выводы
finds|находит
over|более,над,заново,сверх
overs|кончено,сверху,остатки
any|любой
after|за,после
day|день
days|дней
where|где
thing|вещь,предмет
things|вещи
most|наиболее,большинство
should|должен
shoulda|надо-было,должен-был
shouldn't|не-следует
need|потребность,нуждаться
needed|нужный
needing|нуждающийся
needs|потребности
much|много
right|правильно,верно,правый,правильный
righted|выпрямленный? привёл-в-порядок
righting|исправление,приведение-в-порядок
rights|права
how|как
back|спина,назад
backed|поддержанный
backing|поддержка
backs|спины
mean|среднее иметь-в-виду означать предназначать неважный посредственный
meaner|злее
meanest|подлейший
meaning|значение
meanings|значения
means|означает
meant|имел-в-виду
even|даже 2.ровный
evened|выровняли
evens|выравнивает
may|может,мочь,можно 2.май
here|здесь,сюда
many|много
such|такой
last|длиться/2.прошлый,последний
lasted|длился
lasting|длительный,долговечный,прочный? ~эластичный
lasts|длится
child|ребёнок
children|дети
tell|рассказать,говорить,рассказывать
telling|рассказывая
tells|рассказывает
told|сказал
really|действительно,реально
call|звонок,звать,вызов
called|называется
calling|звонок
calls|звонки
before|до
company|компания
companies|компании
through|через
down|вниз
downed|сбитый?
downing|спуск
downs|падения
show|шоу,показывать
showed|показал
showing|показывающий
shown|показано
shows|показывает
life|жизнь
man|мужчина,человек,мужик
manned|пилотируемый
manning|комплектование
mans|мужчины
men|мужчины
change|изменение,изменять 2.сдача,мелочь
changed|измененный
changes|изменения
changing|меняется
place|место
placed|размещен
places|места
placing|размещение
long|длинный
longed|долгожданный
longer|дольше
longest|самый-длинный
longing|тоска
longs|длинные
between|между
feel|чувствовать,трогать,щупать
feeling|чувство
feelings|чувства
feels|чувствует
felt|чувствовал-себя как фуФЕЛ Там
too|тоже,слишком,очень
still|всё-ещё
stilled|успокоенный
stiller|более-тихий(неподвижный)
stillest|самый-тихий
stilling|успокоение,утихание
stills|неподвижные
problem|проблема
problems|проблемы
write|писать
writes|пишет
writing|письмо
writings|сочинения
written|написано
wrote|написал
same|то-же-самое,такой-же,тот-же
lot|много 2.жребий,судьба
lots|много,ворох
great|отлично,великий,большой
greater|больше
greatest|величайший
greats|великие
try|попытка,пробовать,пытаться
tried|пытался
tries|пытается
trying|пытающийся
leave|оставлять,уйти,покинуть
leaved|оставил
leaves|уходит,листья
leaving|уходящий
number|число
numbered|пронумерованный
numbering|нумерация
numbers|числа
both|оба
own|владеть,собственный,свой
owned|принадлежащий,в-собственности
owning|владеющий,владение
owns|владеет
part|роль 2.часть,разделяться
parted|расстались
parting|расставание
parts|части
point|острие,кончик 2.очко 3.точка,пункт 4.смысл,суть
pointed|остроконечный,заостренный
pointing|указывая
points|точки
little|маленький
littler|меньше
littlest|самый-маленький
help|помощь,помогать
helped|помогло
helping|помогая
helpings|порции?
helps|помогает
ask|просить,спрашивать
asked|спросил
asking|спрашивая
asks|спрашивает
meet|встречать-ся,встретить-ся,познакомить-ся
meeting|встреча
meetings|встречи
meets|встречается
met|встретил
start|начать,начинать
started|начал
starting|начиная
starts|начинается
talk|говорить,разговаривать
talked|говорили
talking|говорящий
talks|переговоры
something|что-нибудь,что-то
put|положить,класть,помещать
puts|ставит,ложит,кладёт
putting|положить
another|любой,другой
become|стать,становиться
became|стал
becomes|становится
becoming|становится
interest|интерес,интересовать
interested|заинтересованный
interesting|интересный
interests|интересы
country|страна,сельская-местность
countries|страны
old|старый
older|старше
oldest|старейший
each|каждый
school|школа
schooled|обученный
schooling|обучение
schools|школы
late|поздно,поздний 2.покойный
later|позже,позднее
latest|последний
high|высокий
higher|выше
highest|самый-высокий
highs|максимумы
different|другой,разный,отличающийся
off|выключено,из,вне
offed|убит (сленг), уволен (сленг), убран
offing|вдали
offs|отключатели,перерывы,отключает
next|следующий
end|заканчивать,конец
ended|закончился
ending|окончание
ends|заканчивается
live|жить
lived|жил
lives|жизни,живёт
living|жизнь
why|почему
while|пока
whiled|проводил-время,коротал-время
whiles|в-то-время-как
whiling|коротание-времени
world|мир
worlds|миры
week|неделя
weeks|недели
play|играть
played|играл
playing|играя
plays|играет
might|может,мощь
mighta|возможно,мог-бы
mightn't|не-может-быть
must|должен
musta|должен-был,должно-быть
mustn't|не-должен
home|дом
homed|домашний
homes|дома
homing|самонаведение, возвращающийся домой, приводной
never|так-и-не,никогда
include|включать,содержать-в-себе
included|включено
includes|включает-в-себя
including|включая
course|курс
coursed|курсировал,двигался-по-маршруту,пробегал,преследовал
courses|курсы
coursing|движение,течение,преследование
house|дом
housed|размещенный
houses|дома
housing|жилье,корпус
report|доклад,отчёт
reported|сообщили
reporting|отчетность
reports|отчеты
group|группа
grouped|сгруппированный
grouping|группировка
groups|группы
case|случай,дело(уголовное) 2.ящик,футляр,чехол
cased|помещённый-в-ящик,осмотренный
cases|случаи
casing|корпус
casings|оболочки
woman|женщина
women|женщины,быбы
around|вокруг
book|книга 2.забронировать
booked|забронировано
booking|бронирование
bookings|бронирование
books|книги
family|семья
families|семьи
seem|казаться
seemed|казалось
seeming|кажущийся
seems|кажется
let|пусть,позволять
lemme|дайте-мне
lets|позволяет
letting|сдача-в-аренду
again|снова
kind|добрый 2.тип,вид
kinder|добрее
kindest|добрейший
kinds|виды
keep|держать,хранить
keeping|сохранение
keeps|держит
kept|сохранил,сохраненный
hear|слышать
heard|слышал
hearing|слушание
hears|слышит
system|система
systems|системы
every|каждый
question|вопрос
questioned|под-сомнение,допрашивали
questioning|допрос
questions|вопросы
during|во время
always|всегда
big|большой
bigger|больше
biggest|самый-большой
set|установить,наладить 2.набор,комплект
sets|наборы
setting|параметр
settings|настройки
small|маленький
smaller|меньше
smallest|наименьший
study|исследование,учиться,изучать
studied|изучал
studies|исследования,изучает
studying|изучение
follow|следовать за
followed|последовало
following|следующий
follows|следует
begin|начать,начинать
began|началось
beginning|начало
beginnings|начало
begins|начинается
begun|начатый бег бегуна на старте
important|важно,важный
since|с-тех-пор
run|бежать,бегать,управлять
ran|побежал
running|бег,беготня
runs|работает,бежит
under|под
turn|поворот,повернуть,очередь,смена
turned|повернутый
turning|поворот
turns|повороты
few|несколько,немного,мало
fewer|меньше
fewest|наименьшее-количество
bring|приносить,принести
bringing|принося
brings|приносит
brought|принес
early|ранний,рано
earlier|ранее
earliest|самый-ранний
hand|рука,кисть
handed|вручил
handing|вручение
hands|руки
state|государство 2.заявить,отметить 3.состояние
stated|заявил
states|состояния
stating|заявляя
move|двигаться,переезжать
moved|взолнованный?
moves|движется
moving|движущийся
money|деньги
fact|факт
facts|факты
however|как-бы-ни,однако,тем-не-менее,несмотря-на-это
area|площадь,область,участок
areas|области
provide|предоставить,снабжать
provided|предоставил
provides|обеспечивает
providing|предоставление
name|имя,назвать
named|названный
names|имена
naming|именование
read|читать
reading|чтение
readings|чтения
reads|читает
friend|друг
friends|друзья
month|месяц
months|месяцев
large|большой,широкий
larger|больше
largest|самый-большой
business|занятие,бизнес
businesses|предприятия
without|без
information|информация
open|открыть
opened|открылся
opening|открытие
openings|открытия
opens|открывается
order|заказ,заказывать 2.порядок,упорядочивать 3.приказ
ordered|заказал,упорядоченный
ordering|заказ,выписка
orders|заказы
government|власть,правительство
governments|правительства
word|слово
worded|сформулированный?
wording|формулировка?
words|слова
issue|вопрос,проблема 2.издать,выпустить,выпуск
issued|изданный
issues|проблемы
issuing|выдача
market|рынок
marketed|продаваемый
marketing|маркетинг
markets|рынки
pay|платить
paid|оплаченный
paying|платит,платёж
pays|платит
build|построить,строить
building|здание
buildings|здания
builds|строит
built|построенный
hold|держать,удерживать
held|держал
holding|проведение
holdings|холдинги
holds|держит
service|служба,услуга, обслуживание
serviced|обслуживаемый
services|услуги
servicing|обслуживание
against|против
believe|полагать,верить
believed|верил
believes|верит
believing|веря
second|второй,секунда
sec|сек
seconded|прикомандированный? поддержан?
seconding|прикомандирование?, поддержание-предложения?
seconds|секунды
though|хотя
yes|да
yeses|да
love|любовь,любить
loved|любил
loves|любит
loving|любящий
increase|увеличивать-ся,увеличение
increased|повысился
increases|увеличивается
increasing|увеличивается
job|работа
jobbing|временная работа по найму по мелочи
jobs|рабочие-места
plan|план
planned|запланировано
planning|планирование
plans|планы
result|результат
resulted|в-результате
resulting|в-результате?
results|результаты
away|прочь
example|пример
examples|примеры
happen|случаться,случиться,происходить
happened|случилось
happening|происходит,событие
happenings|события
happens|случается
offer|предлагать,предложение
offered|предложенный
offering|предлагая
offerings|предложения?
offers|предложения
young|молодой
younger|моложе
youngest|самый-молодой
close|закрывать,закрыть 2.близко,почти
closed|закрыто
closing|закрытие
closes|закрывается
closer|ближе
closest|ближайший
program|программа
programs|программы
programed|запрограммированный
programing|программирование
programme|программа
lead|вести 2.свинец
leading|ведущий
leads|ведет
led|вёл,светодиод
buy|купить,верить,соглашаться(разг)
bought|купил
buying|покупка
buys|покупает
understand|понять,понимать
understanding|понимание
understands|понимает
understood|понял
thank|поблагодарить,благодарить
thanked|поблагодарил
thanking|благодаря
thanks|Спасибо
far|далёкий,далеко
farther|дальше
farthest|самый-дальний
today|сегодня
hour|час
hours|часы
student|студент
students|студенты
face|лицо
faced|столкнулся
faces|лица
facing|лицом,облицовка
hope|надежда,надеяться
hoped|надеялся
hopes|надежды
hoping|надеясь
idea|идея
ideas|идеи
cost|расходы,стоить,стоимость
costing|калькуляция-себестоимости?
costs|расходы
less|меньше,менее
room|комната,место,пространство
roomed|имеющий-комнаты
rooming|проживание-в-комнате
rooms|комнаты
until|до,до-тех-пор,пока
reason|причина,мотив 2.разум,благоразумие
reasoned|обоснованный,аргументировано?
reasoning|рассуждение?
reasons|причины
form|форма
formed|сформированный
forming|формирование,образование
forms|формы
spend|тратить,расходовать
spending|расходы
spends|тратит
spent|потраченный
head|голова
headed|возглавлял,озаглавленный
heading|заголовок
headings|заголовки
heads|головы
car|автомобиль,машина
cars|автомобили
learn|учиться
learned|узнал
learning|обучение
learns|учится
learnt|узнал
level|уровень
leveled|выровнял,выровненный
leveling|выравнивание
levels|уровни
person|человек
persons|лица
experience|опыт
experienced|опытный
experiences|опыты
experiencing|испытывая
once|один-раз,однажды,когда-либо
member|член
members|члены
enough|достаточно
bad|плохо,плохой
worse|хуже
worst|худший
city|город
cities|города
night|ночь
nights|ночи
able|могущий,способный
abler|более-способный
ablest|самый-способный
support|поддерживать,поддержка
supported|поддерживается
supporting|поддерживающий
supports|поддерживает
whether|будь-то,ли
line|ряд,строка,линия
lined|выровненный, морщинистый?
lines|линии
lining|оболочка? подкладка?
present|подарок,настоящее(время) 2.присутствующий,в-наличии
presented|представлено
presenting|представляя,предъявление
presents|представляет
side|сторона
sided|односторонний,сторонний
sides|стороны
siding|сайдинг
quite|довольно,вполне,более-менее
although|хотя,хотя-и
sure|верный,уверенный 2.конечно-да(ответ-на-вопрос)
surer|вернее
surest|самый-верный
term|термин,срок,период
termed|названный
terming|название,термин
terms|условия,отношения
least|наименее
age|возраст,век,эпоха
aged|в-возрасте
aging|старение
ages|возрасты
low|низкий
lowed|пониженный,занижен,мычал?
lower|ниже
lowered|снижен,сниженный
lowering|понижение
lowing|мычание?
lowers|понижает
lowest|самый-низкий
lows|минимумы
speak|говорить
speaking|говорящий
speaks|говорит
spoke|говорил
spoken|разговорный
within|в-пределах,внутри 2.в-течение
process|обработать,процесс
processed|обработано
processes|процессы
processing|обработка
public|публичный
often|часто
train|поезд 2.обучать,тренировать
trained|обученный
training|обучение
trains|поезда
possible|возможный,возможно
actually|на-самом-деле,реально
rather|скорее,предпочтительнее
view|вид,взгляд
viewed|просмотрено
viewing|просмотр
views|просмотров
together|вместе
consider|рассмотреть,рассматривать,учитывать 2.считать-чем-либо
considered|обдуманный
considering|учитывая
considers|считает
price|цена
priced|по-цене
prices|цены
pricing|ценообразование,калькуляция
parent|родитель
parented|родительский,воспитанный-родителем
parenting|воспитание-детей
parents|родители
hard|тяжёлый,жёсткий
harder|сильнее,тяжелее
hardest|самый-трудный
party|вечеринка
partied|тусовался
parties|вечеринки
partying|вечеринки,устраивать-вечеринки
local|местный,местный-житель
locals|местные-жители
control|контроль
controlled|контролируемый
controlling|контролирующий,контрольный
controls|контролирует
already|уже
concern|беспокойство,забота,тревожить
concerned|обеспокоенный
concerning|касательно? относительно?
concerns|обеспокоенность
product|продукт
products|продукты
lose|проиграть,терять,проигрывать
loses|теряет
losing|проигрыш
lost|потерянный
story|история,рассказ
storey|этаж?
storied|легендарный?
stories|истории
almost|почти
continue|продолжать,продолжить
continued|продолжение,продолжающийся
continues|продолжается
continuing|продолжая,продолжение
stand|стоять
standing|стоя,положение
stands|стоит
stood|стоял
whole|целое,весь
wholes|целые
yet|пока,ещё,всё-же
rate|курс,тариф,ставка 2.показатель,уровень,оценивать
rated|оцененный,номинальный
rates|ставки
rating|рейтинг
ratings|рейтинги
care|забота,уход
cared|заботился
cares|заботится
caring|заботливая
expect|ожидать
expected|ожидал
expecting|ожидая
expects|ожидает
effect|эффект
effected|произведенный? осуществленный?
effecting|эффект,воздействие
effects|эффекты
sort|сортировать,сорт
sorted|сортированный
sorting|сортировка
sorts|сортирует
ever|всегда,когда-либо
anything|что-угодно,что-либо
cause|причина,быть-причиной
caused|вызванный
causes|причины
causing|вызывая
fall|осень 2.падать,впадать,падение
fallen|упал,упавший
falling|падение
falls|падает
fell|упал,валить-вырубать?
deal|иметь-дело,сделка
dealing|дело,занимающийся
deals|сделки
dealt|сданный,разобрано
water|вода
watered|политый,разбавленный
watering|полив
waters|воды
send|отправлять,отправить
sending|отправка
sends|посылает
sent|отправил,посланный
allow|позволять,разрешать
allowed|допустимый,допущенный
allowing|позволяя,позволяющий
allows|позволяет
soon|скоро,рано
sooner|скорее
soonest|скорей-всего
watch|смотреть,часы-наручные
watched|смотрел
watches|часы,смотрит
watching|наблюдая,наблюдающий
base|база,основа,основывать 2.низкий,подлый
based|основанный-на
baser|базовый,подлее
bases|базы
basest|подлейший,самый-низменный
basing|базирование
probably|вероятно,возможно
suggest|предложить,предлагать
suggested|предложенный
suggesting|предлагая,предлагающий
suggests|предполагает
past|мимо 2.прошлый,прошедший,прошлое
power|власть,сила,мощность
powered|питание?
powering|питание
powers|полномочия
test|тест
tested|проверено
testing|тестирование
tests|тесты
visit|посещение,посещать,посетить,визит
visited|посетил
visiting|посещение
visits|визиты
center|центр
centre|центр
centers|центры
centres|центры
centered|центрированный
centering|центрирование
grow|расти,выращивать 2.становиться
grew|вырос
growing|растет
grown|вырос
grows|растет
nothing|ничто,ничего
return|возвращение,возвращаться
returned|вернулся
returning|возвращение
returns|возвращается
mother|мать
mothered|получивший-материнскую-заботу,заботившийся
mothering|материнство
mothers|матери
walk|прогулка,идти-пешком,ходить
walked|ходил
walking|ходьба
walks|прогулки
matter|вещество,материя % 2.дело,вопрос 3.иметь-значение
mattered|имело-значение
mattering|значение,важность,имеющий-значение
matters|дела
mind|ум,разум,возражать
minded|мыслящий
minding|присмотр?
minds|умы
value|значение,ценить,ценность,оценивать
valued|ценится
values|ценности
valuing|оценивание
office|офис
offices|офисы
record|запись,записывать,рекорд
recorded|записано
recording|записывание
recordings|записи?
records|записи
stay|остаться,оставаться 2.остановиться-пожить
stayed|остался
staying|оставаясь
stays|остается
force|сила,заставить
forced|принужденный
forces|силы
forcing|принуждение
stop|стоп,останавливать-ся
stopped|остановился
stopping|остановка
stops|останавливается
several|несколько
light|светлый,свет,зажигать 2.лёгкий
lighted|освещенный
lightest|самый-легкий
lighting|освещение
lights|огни
lit|горит
develop|развивать,разрабатывать
developed|развитый
developing|развивающийся
develops|развивается
remember|помнить
remembered|вспомнил
remembering|вспоминая
remembers|помнит
bit|бит,немного
bits|биты
share|поделиться,делиться,делить,доля,разделять(мнение)
shared|поделился
shares|акции
sharing|обмен?
real|настоящий,реальный
answer|ответ,отвечать
answered|ответил
answering|отвечая
answers|ответы
sit|сидеть,сажать
sat|сидел
sits|сидит
sitting|сидя
figure|полагать,думать,фигура
figured|понял
figures|цифры?
figuring|вычисляя?
letter|буква,письмо
lettering|надпись
letters|буквы
decide|решать,решить
decided|решенный
decides|решает
deciding|решая
language|язык,язык-общения
languages|языки
subject|подверженный,подвергать 2.предмет,тема
subjected|подвергался
subjecting|подвергая
subjects|предметы,темы
class|сорт,класс
classed|классифицированный
classes|классы
classing|классификация
development|развитие
developments|разработки
town|город,городок
towns|города
half|половина
halved|пополам
halves|половинки
halving|уменьшение-вдвое
minute|минута
minutes|минуты
food|еда
foods|продукты-питания
break|ломать,нарушать 2.перерыв,перемена
breaking|ломать
breaks|перерывы
broke|ломанный
broken|сломанный
clear|ясно,прозрачный,ясный,чистый
cleared|очищено
clearer|яснее,очиститель
clearest|яснейший
clearing|очистка
clears|очищает
future|будущий,будущее
futures|фьючерсы
either|или,либо 2.любой-из-двух 3.тоже(не)
ago|назад
per|за,кол-во на единицу,в
remain|оставаться
remained|остался
remaining|оставшийся
remains|остатки,останки
top|верх
topped|увенчанный
topping|начинка?
toppings|начинки?
tops|вершины
among|среди
win|победа,победить,побеждать
winning|победа,выигрыш
winnings|выигрыши
wins|победы
color|цвет
colour|цвет
colored|цветной
coloured|цветной
coloring|раскрашивание
colouring|раскрашивание
colors|цвета
colours|цвета
involve|включать
involved|вовлеченный
involves|включает-в-себя
involving|с-участием
reach|достигать,достичь
reached|достиг
reaches|достигает
reaching|достигая
social|общественный,социальный
period|точка(в-предложении),период
periods|периоды
across|за,через
note|примечание,заметка,запись
noted|отмеченный
notes|примечания
noting|отмечая
history|история
histories|истории
create|создать,создавать
created|созданный
creates|создает
creating|создание
drive|привод,водить-машину,вести-машину
driven|управляемый
drives|диски
driving|вождение
drove|поехал
along|вдоль
type|печатать,набирать-текст 2.тип
typed|напечатанный
types|типы
typing|печатание
sound|звук,здоровый
sounded|звучало
sounding|звучание
sounds|звуки
eye|глаз
eyed|глазастый
eyeing|присматриваясь
eyes|глаза
music|музыка
game|игра
gamed|играл,манипулировал
games|игры
gaming|игровой
political|политический
free|бесплатно,бесплатный 2.свободный
freed|освобожденный
freeing|освобождение
freer|свободнее
frees|освобождает
freest|самый-свободный
receive|получать,получить
received|полученный
receives|получает
receiving|получение
moment|момент
moments|моменты
sale|распродажа,продажа,сбыт
sales|продажи
policy|курс,политика
policies|политики
further|далее
furthered|продвинулся
furthering|дальнейшее
furthers|далее
body|тело
bodied|телесный
bodies|тела
require|требовать
required|необходимый
requires|требует
requiring|требующий
wait|подожди,ждать
waited|ждал
waiting|ожидающий
waits|ждет
general|общее,общий
generals|генералы
appear|появляться,казаться
appeared|появился
appearing|появляясь
appears|появляется
toward|к,по-направлению-к
towards|к
team|команда,бригада
teamed|объединились
teaming|объединение-в-команду
teams|команды
easy|легко,лёгкий
easier|полегче
easiest|самый-простой
individual|индивидуальный
individuals|индивидуумы
full|полный
fuller|полнее
fullest|самый-полный
black|чёрный
blacked|почерневший
blacker|чернее
blackest|самый-черный
blacking|чернение
blacks|черные
sense|смысл,значение 2.чувство,осознание
sensed|почувствовал
senses|чувства
sensing|зондирование?
perhaps|возможно
add|добавить,добавлять
added|добавлен
adding|добавление
adds|добавляет
rule|правило 2.править
ruled|правил
rules|правила
ruling|постановление?
rulings|постановления
pass|пройти
passed|прошедший
passes|проходит
passing|прохождение
produce|производить
produced|произведено
produces|производит
producing|производство
sell|продать,продавать
selling|продажа
sells|продает
sold|продал
short|короткий
shorted|закороченный
shorter|короче
shortest|самый-короткий
shorting|замыкание
shorts|шорты
agree|согласен,соглашаться
agreed|согласованный
agreeing|соглашаясь
agrees|соглашается
law|закон
laws|законы
everything|всё
research|исследование,исследовать
researched|исследовал
researches|исследования,исследует
researching|исследование
cover|крышка,накрывать,покрывать
covered|покрытый
covering|покрытие
coverings|покрытия
covers|охватывает,покрывает
paper|бумага,документ
papered|оклеенный-бумагой
papering|оклеивание-обоями
papers|документы
position|позиция
positioned|позиционируется
positioning|позиционирование
positions|позиции
near|рядом,около,приближать-ся
neared|приблизился
nearer|ближе
nearest|ближайший
nearing|приближается,приближение
nears|приближается
human|человек,человеческий
humans|люди
computer|компьютер
computers|компьютеры
situation|ситуация
situations|ситуации
staff|персонал
staffed|укомплектованный
staffing|кадровое-обеспечение
staffs|посохи?
activity|деятельность,активность
activities|деятельность
film|фильм,снимать-кино
filmed|снято
filming|съёмка
films|фильмы
morning|утро
mornings|утра
war|война
warred|воевал,сражался
warring|воюющий
wars|войны
account|отчёт 2.счёт(в-банке)
accounted|учтено
accounting|бухгалтерский-учет
accounts|счета
shop|магазин
shopped|делал-покупки
shopping|шоппинг
shops|магазины
major|майор,главный,большой
majored|специализировался?
majoring|по-специальности?
majors|майоры
someone|кто-то
above|над,выше,ранее
design|рисунок,план,дизайн
designed|разработанный
designing|проектирование
designs|конструкции
event|событие
events|события
special|особенный,специальный
specials|специальные-предложения
sometimes|иногда
condition|состояние 2.условие
conditioned|обусловленный
conditioning|кондиционирование
conditions|условия
carry|нести,носить
carried|унесенный
carries|несет
carrying|несущий
choose|выбрать,выбирать
chooses|выбирает
choosing|выбирая
chose|выбрал
chosen|выбранный
father|отец
fathered|отцовский
fathering|отцовство
fathers|отцы
decision|решение
decisions|решения
table|стол,таблица
tabled|вынесен-на-обсуждение?
tables|таблицы
certain|определённый,уверенный
forward|вперёд
forwarded|переслал?
forwarding|пересылка?
forwards|вперед
main|главный,основной
die|умереть
died|умер
dies|умирает
dying|умирающий
bear|медведь 2.нести(+перен) 3.рожать
bearing|несущий
bearings|подшипники?
bears|медведи
borne|нести?
cut|вырезать,резать
cuts|порезы
cutting|резка
cuttings|черенки?
describe|описывать,описать
described|описанный
describes|описывает
describing|описывая
himself|сам
available|доступно,доступный,в-наличии
especially|особенно
strong|сильный
stronger|сильнее
strongest|сильнейший
rise|подъем,рост,подниматься,повышение
risen|воскрес
rises|поднимается
rising|растет
girl|девушка,девочка
girls|девушки
maybe|может-быть
community|сообщество
communities|сообщества
else|ещё
particular|особый,частный,конкретный
particulars|подробности
role|роль
roles|роли
join|присоединиться
joined|присоединился
joining|присоединение
joins|присоединяется
difficult|трудный
please|пожалуйста 2.радовать,получать-удовольствие
pleased|довольный
pleases|радует
pleasing|приятный
detail|деталь(перен)
detailed|подробный
detailing|детализация
details|подробности
difference|разница
differences|различия
action|действие
actions|действия
health|здоровье
eat|есть,кушать
ate|ел
eaten|съеденный
eating|поедание
eats|ест
step|шаг,ступать
stepped|шагнул
stepping|шагать,шагая
steps|шаги
true|правда,верный,правильный,истинный
trued|выверенный,выпрямленный,проверено
truer|вернее
truest|самый-верный
trues|правды,истины,выравнивает
truing|выравнивание? проверка-точности
phone|телефон
phoned|позвонил
phones|телефоны
phoning|звонок
themselves|сами
draw|рисовать 2.тянуть
drawing|рисунок
drawings|рисунки
drawn|нарисованный
draws|рисует
drew|нарисовал
white|белый
whites|белые
whiter|белее
whitest|самый-белый
date|дата 2.свидание,встречаться
dated|датированный
dates|даты
dating|встречаться
practice|упражняться,практиковать,практика
practise|упражняться
practiced|практиковал
practices|практики
practicing|практикующий,занимающийся
model|модель,моделировать
modeled|смоделированный
modeling|моделирование
models|модели
raise|поднимать,поднять,повысить 2.растить(детей)
raised|поднятый
raises|поднимает
raising|повышение
customer|клиент
customers|клиенты
front|перед,передний
fronted|фасад?
fronting|фасад
fronts|фронты
explain|объяснить,объяснять
explained|объяснил
explaining|объясняя
explains|объясняет
door|дверь
doors|двери
outside|снаружи
outsides|снаружи
behind|позади,за
economic|экономический
economics|экономика
site|местоположение 2.сайт
sited|расположен
sites|сайты
approach|подход,приближаться,подходить
approached|приблизился
approaches|подходы
approaching|приближается
teacher|учитель
teachers|учителя
land|высаживаться-на-берег,приземляться 2.земля
landed|приземлился
landing|посадка
landings|посадки
lands|земли
charge|заряд,заряжать,нагружать 2.обвинять 3.плата
charged|заряженный
charges|обвинения заряды заряжает сборы расходы издержки
charging|зарядка
finally|наконец-то
sign|знак 2.подпись,подписывать
signed|подписано
signing|подписание
signs|знаки
===========================================|
claim|требование
claimed|утверждал
claiming|утверждая
claims|претензии
relationship|отношения
relationships|отношения
travel|путешествие
traveled|путешествовал
traveling|путешествие
travelled|путешествовал
travelling|путешествие
travels|путешествия
enjoy|наслаждайтесь
enjoyed|понравилось
enjoying|наслаждаясь
enjoys|наслаждается
death|смерть
deaths|летальные-исходы
nice|хорошо
nicer|лучше
nicest|самый-хороший
amount|сумма
amounted|составил
amounts|суммы
improve|улучшить
improved|улучшенный
improves|улучшается
improving|улучшение
picture|картинка
pictured|на-фото
pictures|фотографии
picturing|изображение
boy|мальчик
boys|мальчики
regard|отношение
regarded|расценено
regarding|касательно
regards|с-уважением
organization|организация
organisation|организация
organisations|организации
organizations|организации
happy|счастливый
happier|счастливее
happiest|самый-счастливый
couple|пара
coupled|в-паре
couples|пары
coupling|муфта
act|акт
acted|действовал
acting|действующий
acts|акты
range|диапазон
ranged|дальний
ranges|диапазоны
ranging|ранжирование
quality|качество
qualities|качества
project|проект
projected|прогнозируемый
projecting|проецирование
projects|проекты
round|раунд
rounded|округлый
rounder|круглее
roundest|самый-круглый
rounding|округление
rounds|раундов
opportunity|возможность
opportunities|возможности
road|дорога
roads|дороги
accord|согласие
accorded|предоставлено
according|согласно
accords|аккорды
list|список
listed|перечисленные
listing|листинг
listings|списки
lists|списки
wish|желание
wished|пожелал
wishes|пожелания
wishing|желая
therefore|поэтому
wear|носить
wearing|утомительный
wears|носит
wore|носил
worn|изношенный
fund|фонд
funded|финансируемый
funding|финансирование
funds|фонды
rest|отдых
rested|отдохнувший
resting|отдыхает
rests|остатки
kid|ребенок
kidded|пошутил
kidding|шутя
kids|дети
industry|промышленность
industries|отрасли-промышленности
education|образование
educations|образования
measure|мера
measured|измеренный
measures|меры
measuring|измерение
kill|убить
killed|убит
killing|убийство
killings|убийства
kills|убивает
serve|служить
served|служил
serves|служит
serving|обслуживание
servings|порции
likely|вероятно
likelier|более-вероятный
likeliest|наиболее-вероятный
certainly|конечно
national|национальный
nationals|граждане
itself|сам
teach|учить
taught|учил
teaches|учит
teaching|преподавание
teachings|учения
field|поле
fielded|выставил
fielding|полединг
fields|поля
security|безопасность
securities|ценные-бумаги
air|воздух
aired|вышел-в-эфир
airing|проветривание
airs|воздух
benefit|выгода
benefited|выиграл
benefiting|приносящий-пользу
benefits|преимущества
benefitted|выиграл
benefitting|приносящий-пользу
trade|торговля
traded|торгуется
trades|торги
trading|торговля
risk|риск
risked|рискнул
risking|рисковать
risks|риски
news|новости
standard|стандарт
standards|стандарты
vote|голосование
voted|проголосовали
votes|голоса
voting|голосование
percent|процентов
percents|проценты
focus|фокус
focused|сосредоточенный
focuses|фокусируется
focusing|фокусировка
focussed|сосредоточенный
focusses|фокусируется
focussing|фокусировка
stage|этап
staged|поставленный
stages|этапы
staging|постановка
space|пространство
spaced|разнесенный
spaces|пространства
spacing|интервал
instead|вместо
realize|осознать
realise|понимать
realised|осуществленный
realises|понимает
realising|понимая
realized|осуществленный
realizes|понимает
realizing|понимая
usually|обычно
data|данные
datum|данные
single|одиночный
singled|одиночный
singles|одиночки
singling|выделение
address|адрес
addressed|адресованный
addresses|адреса
addressing|адресация
performance|производительность
performances|выступления
chance|шанс
chanced|случайно
chances|шансы
chancing|случайный
accept|принять
accepted|принял
accepting|принимая
accepts|принимает
society|общество
societies|общества
technology|технология
technologies|технологии
mention|упоминание
mentioned|упомянул
mentioning|упоминая
mentions|упоминает
choice|выбор
choicer|выбирающий
choices|выборы
choicest|отборный
save|сохранить
saved|сохранено
saves|сохраняет
saving|экономия
savings|сбережения
common|общий
commonest|самый-распространенный
culture|культура
cultured|культурный
cultures|культуры
culturing|культивирование
total|всего
totaled|подсчитано
totaling|итого
totalled|подсчитано
totalling|итого
totals|итоги
demand|спрос
demanded|потребовал
demanding|требовательный
demands|требования
material|материал
materials|материалы
limit|предел
limited|ограниченный
limiting|ограничение
limits|пределы
listen|слушать
listened|слушал
listening|слушаю
listens|слушает
due|из-за
wrong|неправильно
wronged|обидели
wronging|несправедливость
wrongs|ошибки
foot|фут
feet|ноги
footed|ступня
footing|фундамент
foots|футы
effort|усилие
efforts|усилия
attention|внимание
attentions|внимания
upon|на
check|проверка
checked|проверено
checking|проверка
checks|чеки
complete|полный
completed|завершенный
completes|завершает
completing|завершение
lie|ложь
lain|лежал
lied|солгал
lies|ложь
lying|врущий
pick|выбрать
picked|выбрал
picking|сбор
picks|выбирает
reduce|уменьшить
reduced|уменьшенный
reduces|уменьшает
reducing|сокращение
personal|личный
personals|личные-объявления
ground|земля
grounded|заземленный
grounding|заземление
grounds|основания
animal|животное
animals|животные
arrive|прибыть
arrived|приехал
arrives|прибывает
arriving|прибывающий
patient|пациент
patients|пациенты
current|текущий
currents|течения
century|век
centuries|века
evidence|доказательства
evidenced|доказано
evidences|доказательства
evidencing|доказывающий
exist|существует
existed|существовал
existing|существующий
exists|существует
similar|подобный
fight|борьба
fighting|борьба
fights|бои
fought|дрался
leader|лидер
leaders|лидеры
fine|отлично
fined|оштрафован
finer|тоньше
fines|штрафы
finest|лучший
fining|штрафование
street|улица
streets|улицы
former|бывший
formers|бывшие
contact|контакт
contacted|связались
contacting|контактируя
contacts|контакты
particularly|в-частности
wife|жена
wives|жены
sport|спорт
sported|щеголял
sporting|спортивный
sports|спорт
prepare|подготовить
prepared|готовый
prepares|готовит
preparing|подготовка
discuss|обсудить
discussed|обсудили
discusses|обсуждает
discussing|обсуждая
response|ответ
responses|ответы
voice|голос
voiced|озвученный
voices|голоса
voicing|озвучивание
piece|часть
pieced|сложенный
pieces|куски
piecing|сшивание
finish|закончить
finished|законченный
finishes|отделка
finishing|отделка
suppose|предположим
supposed|предполагаемый
supposes|предполагает
supposing|предполагая
apply|применить
applied|применяемый
applies|применяется
applying|применение
president|президент
presidents|президенты
fire|огонь
fired|уволенный
fires|пожары
firing|стрельба
firings|обжиги
compare|сравнить
compared|сравнил
compares|сравнивает
comparing|сравнивая
court|суд
courted|ухаживал
courting|ухаживание
courts|суды
police|полиция
policed|полицейский
polices|политики
policing|полицейская-деятельность
store|магазин
stored|хранится
stores|магазины
storing|хранение
poor|плохой
poorer|беднее
poorest|беднейший
knowledge|знание
laugh|смех
laughed|смеялся
laughing|смеясь
laughs|смеется
arm|рука
armed|вооруженный
arming|постановка-на-охрану
arms|оружие
heart|сердце
hearted|сердечный
hearts|сердца
source|источник
sourced|получено
sources|источники
sourcing|поиск
employee|сотрудник
employees|сотрудники
manage|управлять
managed|удалось
manages|управляет
managing|управление
simply|просто
bank|банк
banked|накренен
banking|банковское-дело
banks|банки
firm|фирма
firmed|укрепился
firmer|крепче
firmest|самый-твердый
firming|укрепляющий
firms|фирмы
cell|клетка
celled|клеточный
cells|клетки
article|статья
articled|статья
articles|статьи
articling|артикулирование
fast|быстро
fasted|постился
faster|Быстрее
fastest|самый-быстрый
fasting|пост
fasts|постится
attack|атака
attacked|атакован
attacking|атакующий
attacks|атаки
foreign|иностранный
surprise|сюрприз
surprised|удивлен
surprises|сюрпризы
surprising|удивительно
feature|особенность
featured|избранный
features|функции
featuring|показывая
factor|фактор
factored|факторизованный
factoring|факторинг
factors|факторы
pretty|довольно
prettier|красивее
pretties|милашки
prettiest|самая-красивая
prettying|приукрашивание
recently|недавно
affect|аффект
affected|затронутый
affecting|влияющий
affects|влияет
drop|падение
dropped|упавший
dropping|падение
drops|капли
recent|недавний
relate|относиться
related|связанный
relates|относится
relating|относящийся
official|официальный
officials|должностные-лица
financial|финансовый
financials|финансы
miss|мисс
missed|пропущенный
misses|промахи
missing|отсутствующий
art|искусство
arts|искусство
campaign|кампания
campaigned|агитировал
campaigning|агитация
campaigns|кампании
private|частный
pause|пауза
paused|приостановлено
pauses|паузы
pausing|пауза
everyone|все
forget|забыть
forgets|забывает
forgetting|забывание
forgot|забыл
forgotten|забыли
page|страница
paged|постраничный
pages|страницы
paging|пейджинг
worry|беспокойство
worried|волновался
worries|заботы
worrying|тревожный
summer|лето
summered|летний
summers|лето
drink|напиток
drank|выпил
drinking|питьевой
drinks|напитки
opinion|мнение
opinioned|свое-мнение
opinions|мнения
park|парк
parked|припаркованный
parking|стоянка
parks|парки
represent|представлять
represented|представленный
representing|представляющий
represents|представляет
key|ключ
keyed|ключ
keying|манипуляция
keys|ключи
inside|внутри
insides|внутренности
manager|менеджер
managers|менеджеры
international|международный
internationals|международные
contain|содержать
contained|содержался
containing|содержащий
contains|содержит
notice|уведомление
noticed|заметил
notices|уведомления
noticing|замечая
wonder|чудо
wondered|задавался-вопросом
wondering|интересный
wonders|чудеса
nature|природа
natured|натуральный
natures|натуры
structure|структура
structured|структурированный
structures|структуры
structuring|структурирование
section|раздел
sectioned|секционный
sectioning|секционирование
sections|разделы
myself|я-сам
exactly|точно
plant|растение
planted|посажено
planting|посадка
plants|растения
paint|краска
painted|окрашенный
painting|рисование
paintings|картины
paints|краски
worker|рабочий
workers|рабочие
press|пресса
pressed|нажатый
presses|прессы
pressing|нажимая
whatever|что-угодно
necessary|необходимо
necessaries|предметы-первой-необходимости
region|область
regions|регионы
growth|рост
growths|наросты
evening|вечер
evenings|вечера
influence|влияние
influenced|под-влиянием
influences|влияния
influencing|влияющий
respect|уважение
respected|уважаемый
respecting|уважая
respects|уважает
various|разный
catch|поймать
catches|ловит
catching|ловля
caught|пойманный
thus|таким-образом
skill|умение
skilled|квалифицированный
skills|навыки
attempt|попытка
attempted|попытались
attempting|попытка
attempts|попытки
son|сын
sons|сыновья
simple|простой
simpler|проще
simplest|простейший
medium|средний
mediums|медиумы
average|среднее
averaged|усредненный
averages|средние-значения
averaging|усреднение
stock|запас
stocked|снабженный
stocking|чулок
stocks|акции
management|управление
managements|управления
character|характер
characters|персонажи
bed|кровать
bedded|постельный
bedding|постельные-принадлежности
beds|кровати
hit|удар
hits|хиты
hitting|удар
establish|установить
established|учредил
establishes|устанавливает
establishing|установление
indeed|действительно
final|финал
finals|финалы
economy|экономика
economies|экономики
fit|подходит
fits|подходит
fitted|установлен
fitter|слесарь
fittest|наиболее-приспособленный
fitting|подгонка
fittings|фитинги
guy|парень
guys|ребята
function|функция
functioned|функционировал
functioning|функционирование
functions|функции
yesterday|вчера
yesterdays|вчерашние
image|изображение
imaged|изображенный
images|изображения
imaging|визуализация
size|размер
sized|размер
sizes|размеры
sizing|калибровка
behavior|поведение
behaviors|поведения
behaviour|поведение
behaviours|поведения
addition|дополнение
additions|дополнения
determine|определить
determined|определенный
determines|определяет
determining|определение
station|станция
stationed|размещенный
stationing|размещение
stations|станции
population|население
populations|населения
fail|провал
failed|неуспешный
failing|провал
failings|недостатки
fails|терпит-неудачу
environment|окружающая-среда
environments|среды
production|производство
productions|постановки
contract|контракт
contracted|контрактный
contracting|заключение-контракта
contracts|контракты
player|игрок
players|игроки
comment|комментарий
commented|прокомментировал
commenting|комментирование
comments|комментарии
enter|войти
entered|вошел
entering|входящий
enters|входит
occur|произойти
occurred|произошел
occurring|происходящий
occurs|происходит
alone|в-одиночку
significant|значительный
drug|наркотик
drugged|под-действием-наркотиков
drugging|наркомания
drugs|наркотики
wall|стена
walled|обнесенный-стеной
walling|возведение-стен
walls|стены
series|серия
direct|прямой
directed|направленный
directing|режиссура
directs|направляет
success|успех
successes|успехи
tomorrow|завтра
tomorrows|завтрашние-дни
director|директор
directors|директора
clearly|ясно
lack|отсутствие
lacked|не-хватало
lacking|не-хватает
lacks|не-хватает
review|обзор
reviewed|рассмотрено
reviewing|рассмотрение
reviews|обзоры
depend|зависеть
depended|зависел
depending|в-зависимости
depends|зависит-от
race|раса
raced|мчался
races|гонки
racing|гонки
recognize|распознавать
recognise|распознавать
recognised|признанный
recognises|признает
recognising|распознавание
recognized|признанный
recognizes|распознает
recognizing|распознавая
window|окно
windowed|оконный
windowing|оконный
windows|окна
purpose|цель
purposed|предназначался
purposes|цели
purposing|целеустремленный
department|отдел
departments|отделы
gain|усиление
gained|приобрел
gaining|набирает
gains|прибыль
tree|дерево
trees|деревья
college|колледж
colleges|колледжи
argue|спорить
argued|утверждал
argues|утверждает
arguing|спорить
board|доска
boarded|сели
boarding|посадка
boards|доски
holiday|праздник
holidayed|отдохнувший
holidaying|отпуск
holidays|праздники
mark|отметка
marked|отмечено
marking|маркировка
markings|маркировки
marks|знаки
church|церковь
churched|воцерковленный
churches|церкви
churching|воцерковление
machine|машина
machined|обработанный
machines|машины
machining|обработка
achieve|достичь
achieved|достигнуто
achieves|достигает
achieving|достижение
item|предмет
items|предметы
prove|доказать
proved|доказано
proven|доказано
proves|доказывает
proving|доказывая
cent|цент
cents|центов
season|сезон
seasoned|приправленный
seasoning|приправа
seasonings|приправы
seasons|сезоны
floor|этаж
floored|напольный
flooring|напольное-покрытие
floors|полы
stuff|вещи
stuffed|фаршированный
stuffing|начинка
stuffs|вещи
wide|широкий
wider|шире
widest|самый-широкий
anyone|кто-нибудь
method|метод
methods|методы
analysis|анализ
analyses|анализы
election|выборы
elections|выборы
military|военный
militaries|военные
hotel|отель
hotels|отели
club|клуб
clubbed|дубинкой
clubbing|клубная-жизнь
clubs|клубы
below|ниже
movie|фильм
movies|фильмы
doctor|доктор
doctored|подделано
doctoring|врачевание
doctors|врачи
discussion|обсуждение
discussions|обсуждения
sorry|извините
sorrier|жаль
sorriest|самый-жалкий
challenge|вызов
challenged|бросил-вызов
challenges|проблемы
challenging|испытывающий
nation|нация
nations|нации
nearly|почти
statement|заявление
statements|заявления
link|ссылка
linked|связанный
linking|связывание
links|ссылки
despite|несмотря-на
introduce|представить
introduced|введен
introduces|представляет
introducing|введение
advantage|преимущество
advantaged|привилегированный
advantages|преимущества
ready|готов
readied|подготовленный
readier|готовее
readies|готов
readiest|самый-готовый
readying|подготовка
marry|жениться
married|женатый
marries|женится
marrying|жениться
strike|забастовка
strikes|забастовки
striking|поразительный
struck|ударил
mile|миля
miles|мили
seek|искать
seeking|ищу
seeks|ищет
sought|искал
ability|способность
abilities|способности
unit|единица
units|единицы
card|карта
carded|кардный
carding|кардочесание
cards|карты
hospital|больница
hospitals|больницы
quickly|быстро
interview|интервью
interviewed|интервью
interviewing|интервьюирование
interviews|интервью
agreement|соглашение
agreements|соглашения
release|выпуск
released|выпущенный
releases|релизы
releasing|выпуская
tax|налог
taxed|облагаемый-налогом
taxes|налоги
taxing|налогообложение
solution|решение
solutions|решения
capital|капитал
capitals|столицы
popular|популярный
specific|конкретный
specifics|специфика
beautiful|красивый
fear|страх
feared|боялись
fearing|боясь
fears|страхи
aim|цель
aimed|направленный
aiming|прицеливание
aims|цели
television|телевидение
televisions|телевизоры
serious|серьёзный
target|цель
targeted|целевые
targeting|нацеливание
targets|цели
degree|степень
degrees|градусы
pull|тянуть
pulled|вытащил
pulling|тянуть
pulls|тянет
red|красный
redder|краснее
reddest|самый-красный
reds|красные
husband|муж
husbanded|муженек
husbanding|мужество
husbands|мужья
access|доступ
accessed|доступ
accesses|доступы
accessing|доступ
movement|движение
movements|движения
treat|лечить
treated|обработанный
treating|лечение
treats|угощения
identify|идентифицировать
identified|идентифицированный
identifies|идентифицирует
identifying|идентифицирующий
loss|потеря
losses|потери
shall|должен
modern|современный
pressure|давление
pressured|под-давлением
pressures|давления
pressuring|оказывая-давление
bus|автобус
bused|автобусный
buses|автобусы
busing|автобусинг
treatment|лечение
treatments|лечения
yourself|себя
yourselves|сами
supply|поставка
supplied|поставляется
supplies|запасы
supplying|поставка
village|деревня
villages|деревни
worth|стоит
natural|натуральный
naturals|натуралы
express|экспресс
expressed|выраженный
expresses|выражает
expressing|выражающий
indicate|указать
indicated|указано
indicates|указывает
indicating|указывающий
attend|присутствовать
attended|присутствовал
attending|посещающий
attends|посещает
brother|брат
brothers|братья
investment|инвестиции
investments|инвестиции
score|оценка
scored|забил
scores|оценки
scoring|подсчет-очков
organize|организовать
organise|организовать
organised|организованный
organises|организует
organising|организация
organized|организованный
organizes|организует
organizing|организация
trip|поездка
tripped|споткнулся
tripping|спотыкание
trips|поездки
beyond|дальше
sleep|сон
sleeping|спящий
sleeps|спит
slept|спал
fish|рыба
fished|ловил-рыбу
fishes|Рыбы
fishing|рыбалка
promise|обещание
promised|обещал
promises|обещания
promising|многообещающий
potential|потенциал
potentials|потенциалы
energy|энергия
energies|энергии
trouble|неприятности
troubled|обеспокоенный
troubles|неприятности
troubling|тревожный
relation|отношение
relations|отношения
touch|прикосновение
touched|тронут
touches|прикосновения
touching|трогательно
file|файл
filed|подано
files|файлы
filing|подача
filings|опилки
middle|средний
middled|средний
middles|средние
middling|средний
bar|бар
barred|запрещённый
barring|запрет
bars|бары
suffer|страдать
suffered|пострадал
suffering|страдания
sufferred|пострадал
sufferring|страдание
suffers|страдает
strategy|стратегия
strategies|стратегии
deep|глубокий
deeper|Глубже
deepest|самый-глубокий
deeps|глубины
except|кроме
excepted|исключено
excepting|за-исключением
excepts|за-исключением
clean|чистый
cleaned|очищенный
cleaning|уборка
cleans|очищает
tend|иметь-тенденцию
tended|имел-тенденцию
tending|уход
tends|имеет-тенденцию
advance|аванс
advanced|передовой
advances|авансы
advancing|продвижение
fill|заполнить
filled|заполненный
filling|заполнение
fillings|начинки
fills|заполняет
star|звезда
starred|отмеченный-звездой
starring|в-главных-ролях
stars|звезды
network|сеть
networked|сетевой
networking|нетворкинг
networks|сети
generally|в-целом
operation|операция
operations|операции
match|матч
matched|совпало
matches|совпадения
matching|соответствие
avoid|избегать
avoided|избегал
avoiding|избегая
avoids|избегает
seat|сиденье
seated|сидящий
seating|сидения
seats|места
throw|бросить
threw|бросил
throwing|метание
thrown|брошенный
throws|бросает
task|задача
tasked|поручено
tasking|постановка-задач
tasks|задачи
normal|нормальный
normals|нормали
goal|цель
goals|цели
associate|ассоциированный
associated|связанный
associates|партнеры
associating|ассоциирование
blue|синий
blued|вороненый
bluer|более-синий
blues|блюз
bluest|самый-синий
bluing|воронение
positive|положительный
positives|позитивы
option|вариант
options|параметры
box|коробка
boxed|упакованный-в-коробку
boxes|коробки
boxing|бокс
huge|огромный
huger|огромнее
hugest|самый-огромный
message|сообщение
messaged|отправлено-сообщение
messages|сообщения
messaging|обмен-сообщениями
instance|пример
instanced|инстанцированный
instances|случаи
instancing|экземпляр
style|стиль
styled|стилизованный
styles|стили
styling|укладка
refer|ссылаться
refered|ссылался
refering|ссылаясь
referred|сослался
referring|ссылаясь
refers|относится
cold|холодный
colder|холоднее
coldest|самый-холодный
colds|простуды
push|толчок
pushed|толкнул
pushes|толкает
pushing|толкание
quarter|четверть
quartered|четвертованный
quartering|четвертование
quarters|четверти
assume|предполагать
assumed|предполагается
assumes|предполагает
assuming|предполагая
baby|ребенок
babied|нянчился
babies|младенцы
babying|нянчиться
successful|успешно
sing|петь
sang|пел
singing|пение
sings|поет
sung|спетый
doubt|сомнение
doubted|сомневался
doubting|сомневающийся
doubts|сомнения
competition|конкуренция
competitions|соревнования
theory|теория
theories|теории
propose|предложить
proposed|предложенный
proposes|предлагает
proposing|предлагая
reference|ссылка
referenced|ссылается
references|ссылки
referencing|ссылаясь
argument|аргумент
arguments|аргументы
adult|взрослый
adults|взрослые
fly|летать
flew|полетел
flies|мухи
flown|летал
flying|летающий
document|документ
documented|задокументировано
documenting|документирование
documents|документы
pattern|узор
patterned|узорчатый
patterning|шаблонизация
patterns|узоры
application|приложение
applications|приложения
hot|горячий
hots|горячие
hotter|горячее
hottest|самый-горячий
obviously|очевидно
unclear|неясно
bill|законопроект
billed|выставлен-счет
billing|выставление-счетов
bills|счета
search|поиск
searched|искали
searches|поиски
searching|идет-поиск
separate|отдельный
separated|разделенный
separates|отделяет
separating|разделяющий
central|центральный
centrals|центральные
career|карьера
careered|сделал-карьеру
careering|карьера
careers|карьеры
anyway|в-любом-случае
anyways|в-любом-случае
speech|речь
speeches|речи
dog|собака
dogged|упрямый
dogging|собачье-преследование
dogs|собаки
officer|офицер
officered|офицерский
officering|офицерство
officers|офицеры
throughout|на-протяжении
oil|масло
oiled|смазанный
oiling|смазывание
oils|масла
dress|платье
dressed|одетый
dresses|платья
dressing|заправка
profit|прибыль
profited|получил-прибыль
profiting|прибыль
profits|прибыль
guess|догадка
guessed|угадал
guesses|догадки
guessing|угадывание
fun|веселье
protect|защищать
protected|защищенный
protecting|защищающий
protects|защищает
resource|ресурс
resourced|обеспеченный-ресурсами
resources|ресурсы
resourcing|обеспечение-ресурсами
science|наука
sciences|науки
disease|болезнь
diseased|больной
diseases|болезни
balance|баланс
balanced|сбалансированный
balances|остатки
balancing|балансировка
damage|ущерб
damaged|поврежден
damages|убытки
damaging|разрушительный
basis|основа
author|автор
authored|автор
authoring|авторство
authors|авторы
basic|базовый
basics|основы
encourage|поощрять
encouraged|поощрять
encourages|поощряет
encouraging|поощрение
hair|волосы
haired|волосатый
hairs|волосы
male|мужчина
males|мужчины
operate|работать
operated|прооперирован
operates|работает
operating|операционный
reflect|отражать
reflected|отраженный
reflecting|отражающий
reflects|отражает
exercise|упражнение
exercised|осуществлял
exercises|упражнения
exercising|упражнения
useful|полезный
restaurant|ресторан
restaurants|рестораны
income|доход
incomes|доходы
property|собственность
properties|характеристики
previous|предыдущий
dark|темный
darker|темнее
darkest|самый-темный
imagine|представить
imagined|воображаемый
imagines|воображает
imagining|воображая
imaginings|воображения
okay|хорошо
ok|хорошо
okayed|одобр.
okaying|о'кейинг
okays|ладно
earn|заработать
earned|заработал
earning|зарабатывание
earnings|заработок
earns|зарабатывает
daughter|дочь
daughters|дочери
post|пост
posted|размещено
posting|размещение
postings|сообщения
posts|сообщения
newspaper|газета
newspapers|газеты
define|определить
defined|определенный
defines|определяет
defining|определение
conclusion|заключение
conclusions|выводы
clock|часы
clocked|тактовый
clocking|тактирование
clocks|часы
everybody|все
weekend|выходные
weekending|уикенд
weekends|выходные
perform|выполнять
performed|выполненный
performing|выполнение
performs|выполняет
professional|профессиональный
professionals|профессионалы
mine|мой
mined|добыто
mines|мины
mining|добыча
debate|дебаты
debated|обсуждался
debates|дебаты
debating|обсуждая
memory|память
memories|воспоминания
green|зеленый
greened|озелененный
greener|зеленее
greenest|самый-зеленый
greening|озеленение
greens|зелень
song|песня
songs|песни
object|объект
objected|возражал
objecting|возражая
objects|объекты
maintain|поддерживать
maintained|поддерживается
maintaining|поддержание
maintains|поддерживает
credit|кредит
credited|зачислено
crediting|кредитование
credits|кредиты
ring|кольцо
rang|позвонил
ringed|кольчатый
ringing|звон
rings|кольца
rung|ступенька
discover|обнаружить
discovered|обнаруженный
discovering|открытие
discovers|обнаруживает
dead|мертв
deader|мертвее
deadest|самый-мертвый
afternoon|полдень
afternoons|после-обеда
prefer|предпочитаю
prefered|предпочитаемый
prefering|предпочитая
preferred|предпочитаемый
preferring|предпочитая
prefers|предпочитает
extend|расширить
extended|расширенный
extending|расширение
extends|расширяется
possibility|возможность
possibilities|возможности
direction|направление
directions|направления
facility|объект
facilities|удобства
variety|разнообразие
varieties|разновидности
daily|ежедневно
dailies|ежедневные-газеты
clothes|одежда
screen|экран
screened|экранированный
screening|скрининг
screenings|показы
screens|экраны
track|трек
tracked|отслеживаемый
tracking|отслеживание
tracks|треки
dance|танец
danced|танцевал
dances|танцы
dancing|танцы
completely|полностью
female|женский
females|самки
responsibility|ответственность
responsibilities|обязанности
original|оригинал
originals|оригиналы
sister|сестра
sisters|сестры
rock|рок
rocked|качал
rocking|качание
rocks|скалы
dream|мечта
dreamed|мечтал
dreaming|мечтая
dreams|мечты
dreamt|мечтал
nor|ни
university|университет
universities|университеты
easily|легко
agency|агентство
agencies|агентства
dollar|доллар
dollars|долларов
garden|сад
gardened|садоводство
gardening|садоводство
gardens|сады
fix|исправить
fixed|зафиксированный
fixes|исправления
fixing|фиксация
fixings|крепления
ahead|вперед
cross|крест
crossed|пересекли
crosses|кресты
crossing|пересечение
crossings|переходы
yeah|да
weight|вес
weighted|взвешенный
weighting|взвешивание
weights|веса
legal|законный
proposal|предложение
proposals|предложения
version|версия
versions|версии
conversation|разговор
conversations|разговоры
somebody|кто-то
pound|фунт
pounded|толченый
pounding|стук
pounds|фунты
magazine|журнал
magazines|журналы
shape|форма
shaped|в-форме
shapes|формы
shaping|формирование
sea|море
seas|моря
immediately|немедленно
welcome|добро-пожаловать
welcomed|приветствовали
welcomes|приветствуется
welcoming|приветствуя
smile|улыбка
smiled|улыбнулся
smiles|улыбки
smiling|улыбаясь
communication|коммуникация
communications|коммуникации
agent|агент
agents|агенты
traditional|традиционный
replace|заменить
replaced|заменен
replaces|заменяет
replacing|замена
judge|судья
judged|судили
judges|судьи
judging|судить
herself|сама
suddenly|внезапно
generation|поколение
generations|поколения
estimate|оценка
estimated|оцененный
estimates|оценки
estimating|оценка
favorite|любимый
favorites|избранное
favourite|любимый
favourites|избранное
difficulty|сложность
difficulties|трудности
purchase|покупка
purchased|куплено
purchases|покупки
purchasing|покупка
shoot|стрелять
shooting|стрельба
shootings|расстрелы
shoots|стреляет
announce|объявлять
announced|объявил
announces|объявляет
announcing|объявляя
unless|если-только
independent|независимый
independents|независимые
recommend|рекомендовать
recommended|рекомендуется
recommending|рекомендовать
recommends|рекомендует
survey|опрос
surveyed|обследованный
surveying|геодезия
surveys|опросы
majority|большинство
majorities|большинство
stick|палка
sticking|прилипание
sticks|палочки
stuck|застрявший
request|запрос
requested|запрошено
requesting|запрашивающий
requests|запросы
rich|богатый
richer|богаче
richest|самый-богатый
wind|ветер
winded|запыхавшийся
winding|обмотка
winds|ветры
none|нет
exchange|обмен
exchanged|обменяли
exchanges|обмены
exchanging|обмен
budget|бюджет
budgeted|бюджетный
budgeting|бюджетирование
budgets|бюджеты
famous|знаменитый
blood|кровь
blooded|кровный
blooding|кровопускание
bloods|крови
appropriate|соответствующий
appropriated|присвоенный
appropriates|присваивает
appropriating|присваивающий
block|блок
blocked|заблокирован
blocking|блокировка
blocks|блоки
warm|теплый
warmed|согретый
warmer|теплее
warmest|самый-теплый
warming|потепление
warms|согревает
count|количество
counted|подсчитано
counting|подсчет
counts|имеет-значение
scene|сцена
scenes|сцены
writer|писатель
writers|писатели
content|содержание
contented|довольный
contenting|довольствуясь
contents|содержание
prevent|предотвратить
prevented|предотвращено
preventing|предотвращение
prevents|предотвращает
safe|безопасный
safer|безопаснее
safest|самый-безопасный
invite|пригласить
invited|приглашен
invites|приглашает
inviting|приглашающий
mix|смешивать
mixed|смешанный
mixes|смеси
mixing|смешивание
element|элемент
elements|элементы
effective|эффективный
correct|правильно
corrected|исправлено
correcting|исправление
corrects|исправляет
medical|медицинский
medicals|медицина
admit|признать
admits|признает
admitted|допущенный
admitting|признавая
beat|бит
beaten|избитый
beating|избиение
beatings|избиения
beats|бьет
telephone|телефон
telephoned|позвонил
telephones|телефоны
telephoning|телефонный-звонок
copy|копия
copied|скопировано
copies|копии
copying|копирование
committee|комитет
committees|комитеты
aware|осведомленный
advice|совет
advices|советы
handle|ручка
handled|обработано
handles|ручки
handling|умение-обращаться
glass|стекло
glassed|застекленный
glasses|очки
glassing|остекление
trial|испытание
trialed|испытанный
trialing|испытание
trialled|испытанный
trialling|испытание
trials|испытания
stress|стресс
stressed|напряженный
stresses|стрессы
radio|радио
radioed|радиопередача
radios|радио
administration|администрация
administrations|администрации
complex|комплекс
complexes|комплексы
text|текст
texts|тексты
context|контекст
contexts|контексты
ride|ехать
ridden|ехал
rides|едет
riding|езда
rode|ехал
directly|напрямую
heavy|тяжелый
heavier|тяжелее
heavies|тяжеловесы
heaviest|самый-тяжелый
remove|удалить
removed|удаленный
removes|удаляет
removing|удаление
conduct|поведение
conducted|проведенный
conducting|проведение
conducts|проводит
equipment|оборудование
equipments|оборудование
otherwise|в-противном-случае
title|название
titled|под-названием
titles|названия
titling|титулование
extra|дополнительный
extras|дополнения
executive|исполнительный
executives|руководители
chair|стул
chaired|председательствовал
chairing|председательство
chairs|стулья
expensive|дорогой
sample|образец
sampled|отобранные
samples|образцы
sampling|выборка
samplings|выборки
sex|секс
sexes|полы
deliver|доставить
delivered|доставленный
delivering|доставка
delivers|доставляет
video|видео
videoed|видео
videos|видео
connection|соединение
connections|соединения
connexion|связи
connexions|связи
primary|первичный
primaries|праймериз
weather|погода
weathered|выветренный
weathering|выветривание
weathers|погода
collect|собирать
collected|собрано
collecting|коллекционирование
collects|собирает
inform|информировать
informed|информированный
informing|информирование
informs|информирует
principle|принцип
principled|принципиальный
principles|принципы
straight|прямой
straighter|прямее
straightest|самый-прямой
appeal|апелляция
appealed|подал-апелляцию
appealing|привлекательный
appeals|апелляции
highly|высоко
trust|доверие
trusted|доверенный
trusting|доверяющий
trusts|трасты
wonderful|замечательно
flat|квартира
flats|квартиры
absolutely|абсолютно
flow|поток
flowed|текла
flowing|течет
flows|потоки
fair|справедливый
faired|обтекаемый
fairer|справедливее
fairest|прекраснейший
fairing|обтекатель
fairs|ярмарки
additional|дополнительный
responsible|ответственный
farm|ферма
farmed|выращенный
farming|сельское-хозяйство
farms|фермы
collection|коллекция
collections|коллекции
hang|висеть
hanged|повешенный
hanging|висит
hangings|повешения
hangs|висит
hung|повешенный
negative|отрицательный
negatives|негативы
band|группа
banded|полосатый
bands|полосы
relative|относительный
relatives|родственники
tour|тур
toured|гастролировал
touring|гастроли
tours|туры
alternative|альтернатива
alternatives|альтернативы
software|программное-обеспечение
pair|пара
paired|в-паре
pairing|спаривание
pairings|пары
pairs|пары
ship|корабль
shipped|отправленный
shipping|перевозки
ships|корабли
attitude|отношение
attitudes|отношения
cheap|дешевый
cheaper|дешевле
cheapest|самый-дешевый
double|двойной
doubled|удвоенный
doubles|удваивает
doubling|удвоение
leg|нога
legged|ножки
legging|леггинсы
leggings|леггинсы
legs|ноги
observe|наблюдать
observed|наблюдал
observes|наблюдает
observing|наблюдая
sentence|предложение
sentenced|приговорен
sentences|предложения
sentencing|вынесение-приговора
print|печать
printed|напечатано
printing|печать
printings|печатные-издания
prints|отпечатки
progress|прогресс
progressed|прогрессировал
progresses|прогрессирует
progressing|прогрессирующий
truth|правда
truths|истины
nobody|никто
nobodies|ничтожества
examine|исследовать
examined|осмотрен
examines|исследует
examining|изучение
lay|класть
laid|проложенный
laying|укладка
lays|кладет
speed|скорость
sped|ускорился
speeded|ускоренный
speeding|превышение-скорости
speeds|скорости
politics|политика
reply|ответ
replied|ответил
replies|ответы
replying|отвечая
display|дисплей
displayed|отображается
displaying|отображение
displays|отображает
transfer|передача
transfering|передача
transferred|передано
transferring|передача
transfers|переводы
perfect|идеально
perfected|усовершенствованный
perfecting|совершенствование
perfects|совершенствует
slightly|немного
overall|в-целом
intend|намереваться
intended|намеревался
intending|намереваясь
intends|намеревается
user|пользователь
users|пользователи
respond|ответить
responded|ответил
responding|отвечая
responds|отвечает
dinner|ужин
dinners|обеды
slow|медленно
slowed|замедлился
slower|помедленнее
slowest|самый-медленный
slowing|замедление
slows|замедляет
regular|регулярный
regulars|завсегдатаи
physical|физический
physicals|физические-осмотры
apart|отдельно
suit|костюм
suited|подходит
suiting|костюмный
suits|костюмы
federal|федеральный
reveal|раскрыть
revealed|раскрытый
revealing|раскрывающий
revealled|раскрыл
revealling|раскрывающий
reveals|раскрывает
percentage|процент
percentages|проценты
peace|мир
peaces|миры
status|статус
crime|преступление
crimes|преступления
decline|снижение
declined|отклоненный
declines|снижается
declining|снижение
decade|декада
decades|десятилетия
launch|запуск
launched|запущен
launches|запускает
launching|запуск
warn|предупредить
warned|предупредил
warning|предупреждение
warnings|предупреждения
warns|предупреждает
consumer|потребитель
consumers|потребители
favor|благосклонность
favored|благоприятствовал
favoring|благоприятствующий
favors|благосклонности
favour|услуга
favoured|благоприятствовал
favouring|благоприятствующий
favours|благосклонности
dry|сухой
dried|сушеный
drier|сушилка
dries|высыхает
driest|самый-сухой
drying|сушка
partner|партнер
partnered|партнерство
partnering|партнерство
partners|партнеры
institution|учреждение
institutions|учреждения
spot|пятно
spots|пятна
spotted|пятнистый
spotting|пятнистость
horse|лошадь
horsed|конный
horses|лошади
horsing|верховая-езда
eventually|в-конце-концов
heat|тепло
heated|подогреваемый
heating|обогрев
heats|нагревает
excite|возбуждать
excited|взволнованный
excites|возбуждает
exciting|захватывающий
reader|читатель
readers|читатели
importance|важность
distance|расстояние
distanced|дистанцированный
distances|расстояния
distancing|дистанцирование
guide|руководство
guided|направляемый
guides|гиды
guiding|направляющий
grant|грант
granted|предоставленный
granting|предоставление
grants|гранты
taxi|такси
taxies|такси
taxiing|руление
taxis|Таксис
feed|подача
fed|кормили
feeding|кормление
feedings|кормления
feeds|каналы
pain|боль
pained|огорченный
paining|покраска
pains|боли
sector|сектор
sectors|секторы
mistake|ошибка
mistakes|ошибки
mistaking|ошибочно
mistook|ошибочно-принял
ensure|обеспечить
ensured|обеспечено
ensures|обеспечивает
ensuring|обеспечение
satisfy|удовлетворять
satisfied|удовлетворен
satisfies|удовлетворяет
satisfying|удовлетворяющий
chief|начальник
chiefs|начальники
cool|круто
cooled|охлажденный
coolest|самый-крутой
cooling|охлаждение
cools|охлаждает
expert|эксперт
experts|эксперты
wave|волна
waved|помахал
waves|волны
waving|машет-рукой
south|юг
labor|труд
labored|трудился
laboring|трудящийся
labors|труды
labour|труд
laboured|трудился
labouring|трудящийся
labours|труды
surface|поверхность
surfaced|всплыл
surfaces|поверхности
surfacing|всплытие
library|библиотека
libraries|библиотеки
excellent|отлично
edge|край
edged|обрезной
edges|края
edging|окантовка
camp|лагерь
camped|разбили-лагерь
camping|кемпинг
camps|лагеря
audience|аудитория
audiences|аудитории
lift|лифт
lifted|поднял
lifting|подъем
lifts|подъемники
procedure|процедура
procedures|процедуры
email|электронная-почта
emailed|отправлено-по-электронной-почте
emailing|электронная-почта
emails|электронные-письма
global|глобальный
struggle|борьба
struggled|боролся
struggles|борьба
struggling|столкнувшийся-с-трудностями
advertise|рекламировать
advertised|рекламируемый
advertises|рекламирует
advertising|реклама
advertize|рекламировать
advertized|рекламируемый
advertizes|рекламирует
advertizing|реклама
select|выбрать
selected|выбрано
selecting|выбирая
selects|выбирает
surround|окружать
surrounded|окруженный
surrounding|окружающий
surroundings|окружение
surrounds|окружает
extent|степень
extents|экстенты
river|река
rivers|реки
annual|годовой
annuals|однолетние
fully|полностью
contrast|контраст
contrasted|контрастировал
contrasting|контрастный
contrasts|контрасты
roll|рулон
rolled|прокатанный
rolling|прокатка
rolls|рулоны
reality|реальность
realities|реалии
photograph|фотография
photographed|сфотографировал
photographing|фотографирование
photographs|фотографии
artist|художник
artists|художники
conflict|конфликт
conflicted|конфликтный
conflicting|конфликтующие
conflicts|конфликты
entire|весь
presence|присутствие
presences|присутствия
crowd|толпа
crowded|переполненный
crowding|скученность
crowds|толпы
corner|угол
cornered|загнанный-в-угол
cornering|поворот
corners|углы
gas|газ
gases|газы
gassed|газированный
gasses|газы
gassing|газация
shift|сдвиг
shifted|смещенный
shifting|смещение
shifts|смены
net|нетто
nets|сети
netted|сетчатый
netting|сетка
category|категория
categories|категории
secretary|секретарь
secretaries|секретари
defense|защита
defence|защита
defences|защиты
defenses|защиты
quick|быстрый
quicker|быстрее
quickest|самый-быстрый
cook|повар
cooked|приготовленный
cooking|приготовление-пищи
cooks|повара
spread|распространение
spreading|распространение
spreads|спреды
nuclear|ядерный
scale|масштаб
scaled|масштабированный
scales|весы
scaling|масштабирование
driver|водитель
drivers|водители
ball|мяч
balled|скрученный
balling|мячинг
balls|шары
cry|крик
cried|плакал
cries|крики
crying|плачет
introduction|введение
introductions|введения
requirement|требование
requirements|требования
north|север
confirm|подтвердить
confirmed|подтвержденный
confirming|подтверждающий
confirms|подтверждает
senior|старший
seniors|пожилые-люди
photo|фото
photos|фотографии
refuse|отказаться
refused|отказался
refuses|отказывается
refusing|отказываясь
transport|транспорт
transported|транспортируется
transporting|транспортировка
transports|транспорты
emerge|появиться
emerged|возник
emerges|появляется
emerging|возникающий
map|карта
mapped|нанесенный-на-карту
mapping|картографирование
maps|карты
concept|концепция
concepts|концепции
island|остров
islanded|островной
islanding|островитянство
islands|острова
reform|реформа
reformed|реформированный
reforming|реформирование
reforms|реформы
neither|ни-один
football|футбол
footballs|футбольные-мячи
survive|выжить
survived|выжил
survives|выживает
surviving|выживать
flight|полет
flights|полеты
left|левый
lefts|левые
solve|решить
solved|решено
solves|решает
solving|решение
neighbor|сосед
neighbored|соседствовал
neighboring|соседний
neighbors|соседи
neighbour|сосед
neighboured|соседний
neighbouring|соседний
neighbours|соседи
background|фон
backgrounds|фоны
technique|техника
techniques|методы
traffic|трафик
trafficked|подверглись-торговле-людьми
trafficking|торговля-людьми
trafficks|трафик
traffics|трафик
improvement|улучшение
improvements|улучшения
tool|инструмент
tooled|обработанный
tooling|оснастка
tools|инструменты
consequence|следствие
consequences|последствия
circumstance|обстоятельство
circumstances|обстоятельства
smoke|дым
smoked|копченый
smokes|курит
smoking|курение
reaction|реакция
reactions|реакции
rain|дождь
rained|шел-дождь
raining|идет-дождь
rains|дожди
busy|занят
busied|занят
busier|занятой
busies|занят
busiest|самый-загруженный
busying|занятость
lesson|урок
lessons|уроки
brain|мозг
brained|мозговой
braining|мозгообразование
brains|мозги
mass|масса
massed|массированный
masses|массы
massing|массирование
funny|смешно
funnier|смешнее
funniest|самый-смешной
contribute|внести-вклад
contributed|внес-вклад
contributes|вносит-свой-вклад
contributing|внесение-вклада
failure|неудача
failures|неудачи
schedule|расписание
scheduled|запланировано
schedules|расписания
scheduling|планирование
speaker|оратор
speakers|ораторы
bottom|дно
bottomed|дно
bottoming|дно
bottoms|днища
adopt|усыновить
adopted|усыновленный
adopting|принятие
adopts|принимает
combine|объединить
combined|комбинированный
combines|комбайны
combining|объединение
mountain|гора
mountains|горы
waste|отходы
wasted|потраченный
wastes|отходы
wasting|трата
hide|скрыть
hid|спрятался
hidden|скрытый
hides|скрывает
hiding|прячется
marriage|брак
marriages|браки
ticket|билет
ticketed|выписан-билет
ticketing|Начисление-оплаты
tickets|билеты
meal|еда
meals|еда
colleague|коллега
colleagues|коллеги
bag|сумка
bagged|упакованный
bagging|упаковка-в-мешки
bags|сумки
repeat|повторить
repeated|повторил
repeating|повторяющийся
repeats|повторяется
equal|равный
equaled|равнялся
equaling|выравнивание
equalled|сравнялся
equalling|выравнивание
equals|равно
expression|выражение
expressions|выражения
plus|плюс
pluses|плюсы
extremely|крайне
owner|владелец
owners|владельцы
plane|самолет
planed|планируемый
planes|самолеты
commercial|коммерческий
commercials|рекламные-ролики
lady|леди
ladies|дамы
duty|обязанность
duties|обязанности
strength|сила
strengths|сильные-стороны
connect|подключить
connected|подключен
connecting|подключение
connects|соединяет
cultural|культурный
arrange|организовать
arranged|согласованный
arranges|организует
arranging|аранжировка
scheme|схема
schemed|замышлял
schemes|схемы
scheming|интриги
payment|оплата
payments|платежи
unfortunately|к-сожалению
brief|краткое-изложение
briefed|проинформировал
briefer|кратче
briefest|кратчайший
briefing|брифинг
briefings|брифинги
briefs|трусы
bird|птица
birded|птичий
birding|наблюдение-за-птицами
birds|птицы
demonstrate|демонстрировать
demonstrated|продемонстрировано
demonstrates|демонстрирует
demonstrating|демонстрируя
contribution|вклад
contributions|взносы
appreciate|ценю
appreciated|оценил
appreciates|ценит
appreciating|ценя
chapter|глава
chapters|главы
secret|секрет
secrets|секреты
apparently|по-видимому
novel|роман
novels|романы
union|союз
unions|профсоюзы
burn|сжечь
burned|сгорел
burning|горение
burns|ожоги
burnt|сгорел
trend|тенденция
trended|в-тренде
trending|трендовый
trends|тенденции
initial|начальный
initialed|парафированный
initialing|парафирование
initialled|парафированный
initialling|парафирование
initials|инициалы
pleasure|удовольствие
pleasured|довольный
pleasures|удовольствия
pleasuring|доставляющий-удовольствие
suggestion|предложение
suggestions|предложения
critical|критический
gather|собирать
gathered|собрались
gathering|встреча
gatherings|встречи
gathers|собирает
mostly|в-основном
earth|земля
earthed|заземленный
earths|земли
pop|поп
popped|выскочил
popping|хлопать
pops|хлопает
essential|существенный
essentials|предметы-первой-необходимости
desire|желание
desired|желанный
desires|желания
desiring|желая
promote|продвигать
promoted|повышенный
promotes|продвигает
promoting|продвижение
currently|в-настоящее-время
employ|нанимать
employed|занят
employing|нанимая
employs|нанимает
path|путь
paths|пути
topic|тема
topics|темы
beach|пляж
beached|выброшенный-на-берег
beaches|пляжи
beaching|выбрасывание-на-берег
attract|привлекать
attracted|привлекли
attracting|привлечение
attracts|привлекает
engage|заниматься
engaged|помолвлен
engages|вовлекает
engaging|увлекательный
powerful|мощный
flower|цветок
flowered|цветущий
flowering|цветение
flowers|цветы
crisis|кризис
crises|кризисы
settle|урегулировать
settled|поселился
settles|оседает
settling|урегулирование
boat|лодка
boated|плавал-на-лодке
boating|катание-на-лодке
boats|лодки
aid|помощь
aided|помогал
aiding|помощь
aids|СПИД
fan|вентилятор
fanned|раздуваемый
fanning|раздувание
fans|фанаты
kitchen|кухня
kitchens|кухни
twice|дважды
fresh|свежий
fresher|свежее
freshest|свежайший
delay|задержка
delayed|отложенный
delaying|задержка
delays|задержки
safety|безопасность
safeties|безопасность
engineer|инженер
engineered|спроектированный
engineering|инжиниринг
engineers|инженеры
quiet|тихий
quieted|утихомирился
quieter|тише
quietest|самый-тихий
quieting|успокоение
quiets|тишина
insurance|страхование
insurances|страховки
nurse|медсестра
nursed|выхаживал
nurses|медсестры
nursing|сестринское-дело
divide|делить
divided|разделенный
divides|делит
dividing|разделение
length|длина
lengths|длины
investigation|расследование
investigations|расследования
package|пакет
packaged|упакованный
packages|пакеты
packaging|упаковка
somewhere|где-то
expand|развернуть
expanded|расширенный
expanding|расширяющийся
expands|расширяется
commit|совершить
commits|совершает
committed|преданный-идее
committing|совершение
obvious|очевидный
jump|прыжок
jumped|прыгнул
jumping|прыжки
jumps|прыжки
weapon|оружие
weapons|оружие
relatively|относительно
host|хозяин
hosted|размещенный
hosting|хостинг
hosts|хозяева
winter|зима
wintered|перезимовал
wintering|зимовка
winters|зимы
district|район
districts|районы
broad|широкий
broader|шире
broadest|широчайший
tire|шина
tired|усталый
tires|шины
tiring|утомительно
spring|весна
sprang|прыгнул
springing|подпрыгивание
springs|пружины
sprung|подпрыгнул
spirit|дух
spirited|энергичный
spiriting|воодушевление
spirits|духи
lunch|обед
lunched|обедал
lunches|обеды
lunching|обед
actual|фактический
pool|бассейн
pooled|объединенные
pooling|объединение
pools|бассейны
battle|битва
battled|сражались
battles|сражения
battling|сражающийся
tradition|традиция
traditions|традиции
cash|наличные
cashed|обналичить
cashes|наличные-деньги
cashing|обналичивание
hardly|вряд-ли
award|награда
awarded|награжден
awarding|награждение
awards|награды
coach|тренер
coached|тренировал
coaches|тренеры
coaching|коучинг
experiment|эксперимент
experimented|экспериментировал
experimenting|экспериментируя
experiments|эксперименты
consideration|рассмотрение
considerations|соображения
strange|странный
strangest|самый-странный
code|код
coded|закодированный
codes|коды
coding|кодирование
possibly|возможно
threat|угроза
threats|угрозы
accident|несчастный-случай
accidents|несчастные-случаи
impossible|невозможно
revenue|доход
revenues|доходы
enable|включить
enabled|включено
enables|позволяет
enabling|включение
afraid|боюсь
active|активный
actives|активы
conclude|заключить
concluded|пришли-к-выводу
concludes|заключает
concluding|заключительный
religious|религиозный
cancer|рак
cancers|раковые-заболевания
convince|убеждать
convinced|убежденный
convinces|убеждает
convincing|убедительный
vary|варьироваться
varied|разнообразный
varies|варьируется
varying|варьирующийся
environmental|окружающая-среда
sun|солнце
sunned|загоревший
sunning|загорать
suns|солнца
healthy|здоровый
healthier|здоровее
healthiest|самый-здоровый
blow|удар
blew|взорвался
blowing|дует
blown|взорван
blows|удары
volume|том
volumes|объемы
location|местоположение
locations|локации
invest|инвестировать
invested|инвестировано
investing|инвестирование
invests|инвестирует
proceed|продолжить
proceeded|продолжился
proceeding|продолжающийся
proceedings|разбирательство
proceeds|доходы
wash|мыть
washed|вымытый
washes|моет
washing|стирка
actor|актёр
actors|актеры
glad|рад
gladder|радоваться
gladdest|самый-радостный
tape|лента
taped|заклеенный
tapes|ленты
taping|заклеивание
whereas|тогда-как
opposite|напротив
opposites|противоположности
stone|камень
stoned|побитый-камнями
stones|камни
stoning|побивание-камнями
sum|сумма
summed|суммируется
summing|суммирование
sums|суммы
murder|убийство
murdered|убит
murdering|убийство
murders|убийства
monitor|монитор
monitored|отслеживаемый
monitoring|мониторинг
monitors|мониторы
soldier|солдат
soldiered|солдатский
soldiering|солдатская-служба
soldiers|солдаты
finance|финансы
financed|финансируемый
finances|финансы
financing|финансирование
hate|ненависть
hated|ненавидел
hates|ненавидит
hating|ненавидящий
egg|яйцо
egged|яйца
egging|яичница
eggs|яйца
concert|концерт
concerted|согласованный
concerts|концерты
shock|шок
shocked|шокирован
shocking|шокирующий
shocks|шоки
comfortable|удобный
usual|обычный
carefully|осторожно
pack|пакет
packed|упакованный
packing|упаковка
packs|пакеты
recall|отзыв
recalled|отозванный
recalls|отзывает
wine|вино
wines|вина
wining|победа
camera|камера
cameras|камеры
swim|плавать
swam|плавал
swimming|плавание
swims|плавает
swum|плавал
manufacture|производство
manufactured|изготовлено
manufactures|производит
manufacturing|производство
theater|театр
theaters|театры
theatre|театр
theatres|театры
cycle|цикл
cycled|езда-на-велосипеде
cycles|циклы
cycling|езда-на-велосипеде
coffee|кофе
coffees|кофе
totally|полностью
museum|музей
museums|музеи
visitor|посетитель
visitors|посетители
freedom|свобода
freedoms|свободы
construction|строительство
constructions|конструкции
dear|дорогой
dearer|дороже
dearest|самый-дорогой
dears|дорогие
objective|цель
objectives|цели
moreover|более-того
onto|на
historical|исторический
oppose|противостоять
opposed|выступил-против
opposes|выступает-против
opposing|противостоящий
branch|филиал
branched|разветвленный
branches|ветви
branching|разветвление
vehicle|транспортное-средство
vehicles|транспортные-средства
scientist|ученый
scientists|ученые
route|маршрут
routes|маршруты
bind|связывать
binding|обязательный
binds|связывает
belong|принадлежать
belonged|принадлежал
belonging|принадлежность
belongings|вещи
belongs|принадлежит
taste|вкус
tasted|попробовал
tastes|вкусы
tasting|дегустация
tonight|сегодня-вечером
fashion|мода
fashioned|вылепленный
fashioning|вылепливание
fashions|моды
danger|опасность
dangers|опасности
bomb|бомба
bombed|разбомбили
bombing|бомбардировка
bombings|бомбардировки
bombs|бомбы
army|армия
armies|армии
dangerous|опасный
decrease|уменьшение
decreased|уменьшилось
decreases|уменьшается
decreasing|уменьшение
hurt|больно
hurting|больно
hurts|болит
council|совет
councils|советы
editor|редактор
editors|редакторы
normally|нормально
sight|вид
sighted|зрячий
sighting|прицеливание
sightings|наблюдения
sights|достопримечательности
generate|генерировать
generated|сгенерировано
generates|генерирует
generating|генерирующий
gift|подарок
gifted|одаренный
gifting|дарение
gifts|подарки
delivery|доставка
deliveries|поставки
deny|отрицать
denied|отклонен
denies|отрицает
denying|отрицая
guest|гость
guests|гости
anybody|кто-нибудь
bedroom|спальня
bedrooms|спальни
quote|цитата
quoted|цитируется
quotes|кавычки
quoting|цитирование
climb|восхождение
climbed|поднялся
climbing|восхождение
climbs|подъемы
basically|в-основном
violence|насилие
minister|министр
ministered|служил
ministering|служение
ministers|министры
mainly|в-основном
mouth|рот
mouthed|ртом
mouthing|ругательство
mouths|рты
noise|шум
noises|шумы
manner|манера
mannered|воспитанный
manners|манеры
gun|пушка
gunned|расстрелян
gunning|обстрел
guns|пушки
square|квадрат
squared|в-квадрате
squarer|квадратный
squares|квадраты
squarest|квадратнейший
squaring|возведение-в-квадрат
occasion|случай
occasioned|вызванный
occasioning|поводящий
occasions|случаи
familiar|знакомый
familiars|фамильяры
ignore|игнорировать
ignored|проигнорировано
ignores|игнорирует
ignoring|игнорируя
destroy|уничтожить
destroyed|уничтожено
destroying|разрушающий
destroys|разрушает
affair|дело
affairs|дела
civil|гражданский
locate|найти
located|расположен
locates|находит
locating|нахождение
citizen|гражданин
citizens|граждане
temperature|температура
temperatures|температуры
gold|золото
domestic|внутренний
domestics|прислуга
load|нагрузка
loaded|загружен
loading|загрузка
loads|нагрузки
belief|вера
beliefs|убеждения
troop|отряд
troops|войска
technical|технический
remind|напомнить
reminded|напомнил
reminding|напоминая
reminds|напоминает
arrangement|расположение
arrangements|распоряжения
skin|кожа
skinned|ободранный
skinning|снятие-шкуры
skins|скины
prison|тюрьма
prisons|тюрьмы
switch|переключатель
switched|переключился
switches|переключатели
switching|переключение
acquire|приобретать
acquired|приобретенный
acquires|приобретает
acquiring|приобретение
corporate|корпоративный
fairly|довольно
wood|дерево
wooded|лесистый
woods|леса
participate|участвовать
participated|участвовал
participates|участвует
participating|участие
tough|жесткий
tougher|жестче
toughest|самый-жесткий
tear|слеза
tearing|разрывая
tears|слезы
tore|разорвал
representative|представитель
representatives|представители
capacity|емкость
capacities|мощности
border|граница
bordered|граничил
bordering|граничащий
borders|границы
shake|встряхнуть
shaken|потрясенный
shakes|трясет
shaking|тряска
shook|потрясенный
assessment|оценка
assessments|оценки
shoe|башмак
shod|обут
shoed|обут
shoes|обувь
ought|должен
oughta|надо-было
oughtn't|не-должен
ad|г.н.э.-реклама
ads|объявления
fee|плата
fees|сборы
hall|зал
halls|залы
regulation|регулирование
regulations|правила
escape|побег
escaped|сбежал
escapes|побеги
escaping|побег
studio|студия
studios|студии
proper|собственно
relax|расслабиться
relaxed|расслабленный
relaxes|расслабляет
relaxing|расслабляющий
tourist|турист
tourists|туристы
component|компонент
components|компоненты
afford|​​позволить-себе
afforded|предоставлено
affording|предоставляя
affords|позволяет
lawyer|юрист
lawyers|юристы
suspect|подозреваемый
suspected|подозревал
suspecting|подозревая
suspects|подозреваемые
cup|чашка
cupped|чашеобразный
cupping|купирование
cups|чашки
description|описание
descriptions|описания
confidence|уверенность
confidences|признания
industrial|промышленный
industrials|промышленные-предприятия
complain|жаловаться
complained|жаловался
complaining|жалуясь
complains|жалуется
perspective|перспектива
perspectives|перспективы
error|ошибка
errors|ошибки
arrest|арест
arrested|арестован
arresting|арестовывать
arrests|аресты
assess|оценить
assessed|оцененный
assesses|оценивает
assessing|оценивая
register|регистр
registered|зарегистрирован
registering|регистрация
registers|регистры
asset|актив
assets|ресурсы
signal|сигнал
signaled|сигнализировал
signaling|сигнализация
signalled|сигнализировал
signalling|сигнализация
signals|сигналы
finger|палец
fingered|пальчатый
fingering|аппликатура
fingers|пальцы
relevant|релевантный
explore|исследовать
explored|исследовал
explores|исследует
exploring|исследуя
leadership|лидерство
leaderships|лидерства
commitment|обязательство
commitments|обязательства
wake|поминки
waked|проснулся
wakes|просыпается
waking|пробуждение
woke|проснулся
woken|разбуженный
necessarily|обязательно
bright|яркий
brighter|ярче
brightest|самый-яркий
frame|рамка
framed|оформленный
frames|кадры
framing|обрамление
slowly|медленно
bond|облигация
bonded|связанный
bonding|склеивание
bonds|облигации
hire|прокат
hired|наемный
hires|нанимает
hiring|найм
hole|отверстие
holed|продырявленный
holes|отверстия
holing|дырявить
tie|галстук
tied|связанный
ties|галстуки
tying|завязывание
internal|внутренний
internals|внутренности
chain|цепь
chained|прикованный-цепью
chaining|цепочка
chains|цепи
literature|литература
literatures|литературы
victim|жертва
victims|жертвы
threaten|угрожать
threatened|под-угрозой
threatening|угрожающий
threatens|угрожает
division|разделение
divisions|дивизии
secure|безопасный
secured|обеспеченный
secures|обеспечивает
securing|обеспечение
amaze|удивлять
amazed|поражен
amazes|поражает
amazing|удивительный
device|устройство
devices|устройства
birth|рождение
birthed|рожденный
birthing|роды
births|рождения
forest|лес
forested|лесистый
foresting|лесоводство
forests|леса
label|этикетка
labeled|маркированный
labeling|маркировка
labelled|маркированный
labelling|маркировка
labels|этикетки
root|корень
rooted|укорененный
rooting|укоренение
roots|корни
factory|фабрика
factories|фабрики
expense|расход
expensed|расходы
expenses|затраты
expensing|расходы
channel|канал
channeled|направленный
channeling|ченнелинг
channelled|направленный
channelling|ченнелинг
channels|каналы
investigate|исследовать
investigated|исследовано
investigates|расследует
investigating|расследование
recommendation|рекомендация
recommendations|рекомендации
rank|ранг
ranked|ранжированный
ranking|рейтинг
rankings|рейтинги
ranks|ранги
typical|типичный
west|запад
friendly|дружелюбный
friendlier|дружелюбнее
friendliest|самый-дружелюбный
resident|резидент
residents|резиденты
provision|положение
provisioned|предоставлено
provisioning|предоставление
provisions|положения
concentrate|концентрат
concentrated|концентрированный
concentrates|концентраты
concentrating|концентрируясь
plenty|много
export|экспорт
exported|экспортировано
exporting|экспорт
exports|экспорт
entirely|полностью
strongly|сильно
bridge|мост
bridged|мостовой
bridges|мосты
bridging|мост
consist|состоять
consisted|состоял
consisting|состоящий
consists|состоит
graduate|выпускник
graduated|окончил
graduates|выпускники
graduating|заканчивающий
brand|марка
branded|фирменный
branding|брендинг
brands|бренды
moral|моральный
morals|мораль
insist|настаивать
insisted|настоял
insisting|настаивая
insists|настаивает
combination|комбинация
combinations|комбинации
abuse|злоупотребление
abused|злоупотребляли
abuses|злоупотребления
abusing|злоупотребление
ice|лед
iced|замороженный
ices|льды
principal|главный
principals|директора
master|мастер
mastered|освоил
mastering|мастеринг
masters|мастера
definitely|определенно
session|сессия
sessions|сеансы
grade|класс
graded|градуированный
grades|оценки
grading|оценка
nevertheless|тем-не-менее
predict|предсказать
predicted|предсказанный
predicting|предсказывать
predicts|предсказывает
previously|ранее
protection|защита
protections|защиты
largely|в-значительной-степени
wed|ср
wedded|женился
wedding|свадьба
weddings|свадьбы
weds|женится
rent|аренда
rented|арендованный
renting|аренда
rents|арендная-плата
shot|выстрел
shots|выстрелы
appearance|внешний-вид
appearances|появления
reasonable|разумный
guarantee|гарантия
guaranteed|гарантировано
guaranteeing|гарантирующий
guarantees|гарантии
guaranties|гарантии
guaranty|гарантия
till|до
tilled|пахал
tilling|пахота
tills|кассы
theme|тема
themed|тематический
themes|темы
judgment|суждение
judgments|суждения
odd|нечетный
odder|страннее
oddest|самый-странный
approve|одобрить
approved|одобренный
approves|одобряет
approving|одобряющий
loan|кредит
loaned|одолжил
loaning|кредитование
loans|кредиты
definition|определение
definitions|определения
elect|избранный
elected|избранный
electing|избирающий
elects|избирает
atmosphere|атмосфера
atmospheres|атмосферы
farmer|фермер
farmers|фермеры
comparison|сравнение
comparisons|сравнения
characteristic|характеристика
characteristics|характеристики
license|лицензия
licence|лицензия
licenced|лицензированный
licences|лицензии
licencing|лицензирование
licensed|лицензированный
licenses|лицензии
licensing|лицензирование
rely|полагаться
relied|полагался
relies|полагается
relying|полагаясь
narrow|узкий
narrowed|сужен
narrower|более-узкий
narrowest|самый-узкий
narrowing|сужение
narrows|сужается
succeed|преуспеть
succeeded|удалось
succeeding|преуспевающий
succeeds|преуспевает
identity|личность
identities|идентичности
desk|стол
desks|столы
permit|разрешение
permits|разрешения
permitted|разрешено
permitting|разрешение
seriously|серьезно
wild|дикий
wilder|более-дикий
wildest|самый-дикий
wilds|дебри
empty|пустой
emptied|опорожненный
emptier|пустее
empties|пустые
emptiest|самый-пустой
emptying|опорожнение
commission|комиссия
commissioned|введен-в-эксплуатацию
commissioning|ввод-в-эксплуатацию
commissions|комиссии
unique|уникальный
association|ассоциация
associations|ассоциации
instrument|инструмент
instrumented|инструментированный
instruments|инструменты
investor|инвестор
investors|инвесторы
practical|практический
tea|чай
teas|чаи
lovely|прекрасный
lovelier|красивее
loveliest|прекраснейший
soft|мягкий
softer|мягче
softest|самый-мягкий
row|ряд
rowed|гребной
rowing|гребля
rows|ряды
youth|юность
youths|молодежь
lock|замок
locked|заперт
locking|блокировка
locks|замки
fuel|топливо
fueled|заправленный
fueling|заправка-топливом
fuels|топлива
expectation|ожидание
expectations|ожидания
employment|занятость
employments|занятость
celebrate|праздновать
celebrated|праздновали
celebrates|празднует
celebrating|празднование
sexual|сексуальный
shoulder|плечо
shouldered|взвалил
shoulders|плечи
breath|дыхание
breaths|вдохи
increasingly|все-больше-и-больше
import|импорт
imported|импортированный
importing|импорт
imports|импорт
bottle|бутылка
bottled|бутилированный
bottles|бутылки
bottling|розлив
ourselves|мы-сами
sheet|лист
sheeted|покрытый-листами
sheeting|листовое-покрытие
sheets|листы
engine|двигатель
engines|двигатели
cast|литье
casted|литой
casting|литье
castings|литье
casts|бросает
notion|понятие
notions|понятия
conservative|консервативный
conservatives|консерваторы
journey|путешествие
journeyed|путешествовал
journeying|путешествие
journeys|путешествия
opposition|оппозиция
oppositions|оппозиции
relief|рельеф
reliefs|рельефы
debt|долг
debts|долги
honor|честь
honored|заслуженный
honoring|почитание
honors|почести
honour|честь
honoured|заслуженный
honouring|почитание
honours|почести
outcome|результат
outcomes|результаты
blame|винить
blamed|обвинили
blames|обвиняет
blaming|обвинять
explanation|объяснение
explanations|объяснения
arise|возникнуть
arisen|возник
arises|возникает
arising|возникающий
arose|возник
musical|мюзикл
musicals|мюзиклы
recover|восстановить
recovered|восстановлено
recovering|восстановление
recovers|восстанавливается
dad|папа
daddies|папочки
daddy|папочка
dads|папы
stretch|растянуть
stretched|растянутый
stretches|растягивается
stretching|растяжка
declare|объявить
declared|заявил
declares|заявляет
declaring|декларируя
retire|уйти-в-отставку
retired|ушедший-на-пенсию
retires|уходит-в-отставку
retiring|уходящий-на-пенсию
tiny|крошечный
tinier|мельче
tiniest|мельчайший
careful|осторожный
suitable|подходит
native|родной
natives|туземцы
fruit|фрукты
fruited|плодоносный
fruiting|плодоношение
fruits|фрукты
analyze|анализировать
analyse|анализировать
analysed|проанализировано
analysing|анализируя
analyzed|проанализировал
analyzes|анализы
analyzing|анализируя
witness|свидетель
witnessed|засвидетельствовано
witnesses|свидетели
witnessing|свидетельствование
mail|почта
mailed|отправлено-по-почте
mailing|рассылка
mailings|рассылки
mails|почта
terrible|ужасный
researcher|исследователь
researchers|исследователи
ordinary|обычный
selection|выбор
selections|выборы
anywhere|где-угодно
mental|умственный
participant|участник
participants|участники
vision|видение
visions|видения
personality|личность
personalities|личности
specifically|конкретно
fat|жир
fats|жиры
fatter|толще
fattest|самый-толстый
entry|запись
entries|записи
fellow|парень
fellows|ребята
chemical|химический
chemicals|химикаты
capture|захват
captured|захвачен
captures|захватывает
capturing|захват
tip|наконечник
tipped|наконечник
tipping|чаевые
tips|советы
discount|скидка
discounted|со-скидкой
discounting|дисконтирование
discounts|скидки
peak|пик
peaked|достиг-пика
peaking|пик
peaks|пики
chairman|председатель
chairmen|председатели
proportion|пропорция
proportioned|пропорциональный
proportioning|пропорционирование
proportions|пропорции
ear|ухо
eared|ушастый
ears|уши
disappear|исчезнуть
disappeared|исчезнувший
disappearing|исчезающий
disappears|исчезает
shout|крик
shouted|крикнул
shouting|кричать
shouts|крики
yard|двор
yards|ярды
constant|константа
constants|константы
significantly|значительно
hill|холм
hilled|холмистый
hills|холмы
considerable|значительный
instruction|инструкция
instructions|инструкции
intelligence|интеллект
intelligences|интеллекты
ideal|идеал
ideals|идеалы
folk|народный
folks|близкие
surely|конечно
guard|гвардия
guarded|охраняемый
guarding|охрана
guards|охранники
cat|кот
cats|кошки
somewhat|несколько
kiss|поцелуй
kissed|поцеловал
kisses|поцелуи
kissing|целоваться
presentation|презентация
presentations|презентации
joint|сустав
jointed|сочлененный
jointing|соединение
joints|суставы
compete|соревноваться
competed|соревновались
competes|конкурирует
competing|конкурирующий
poll|опрос
polled|опрошенный
polling|опрос
polls|опросы
weak|слабый
weaker|слабее
weakest|самый-слабый
faith|вера
faiths|веры
reduction|сокращение
reductions|сокращения
reserve|резерв
reserved|сдержанный
reserves|резервы
reserving|резервирование
complaint|жалоба
complaints|жалобы
bore|отверстие
bored|скучающий
bores|скулит
boring|скучный
mission|миссия
missions|миссии
somehow|как-то
tone|тон
toned|тонированный
tones|тоны
toning|тонирование
neighborhood|район
neighborhoods|кварталы
neighbourhood|район
neighbourhoods|кварталы
passenger|пассажир
passengers|пассажиры
justice|правосудие
justices|судьи
phase|фаза
phased|поэтапный
phases|фазы
phasing|фазирование
thin|тонкий
thinned|истонченный
thinner|тоньше
thinnest|самый-тонкий
thinning|истончение
thins|истончается
rush|спешка
rushed|бросился
rushes|спешка
rushing|торопится
formal|формальный
formals|формальности
religion|религия
religions|религии
employer|работодатель
employers|работодатели
reject|отклонить
rejected|отклоненный
rejecting|отвергая
rejects|отклоняет
latter|последний
plate|пластина
plated|покрытый
plates|пластины
plating|покрытие
ban|запрет
banned|запрещен
banning|запрещающий
bans|запреты
steal|украсть
stealing|кража
steals|крадет
stole|украл
stolen|украденный
protest|протест
protested|протестовал
protesting|протестуя
protests|протесты
index|индекс
indexed|индексированный
indexes|индексы
indexing|индексация
indices|индексы
sad|грустный
sadder|печальнее
saddest|самый-грустный
frequently|часто
circle|круг
circled|обведено-кружком
circles|круги
circling|кружащийся
helpful|полезно
command|команда
commanded|приказал
commanding|командующий
commands|команды
attractive|привлекательный
sick|больной
sicker|хуже
sickest|самый-больной
impression|впечатление
impressions|впечатления
unable|неспособный
joke|шутка
joked|пошутил
jokes|шутки
joking|шутка
sky|небо
skies|небеса
column|колонка
columned|колонный
columns|столбцы
electronic|электронный
electronics|электроника
impose|налагать
imposed|навязанный
imposes|навязывает
imposing|внушительный
criminal|преступник
criminals|преступники
besides|кроме-того
properly|правильно
ancient|древний
ancients|древние
coast|побережье
coasted|плыл-по-инерции
coasting|движение-по-инерции
coasts|побережья
ill|больной
ills|беды
kick|удар-ногой
kicked|пнул
kicking|пинать
kicks|пинки
closely|тесно
multiple|множественный
multiples|кратные
yield|выход
yielded|уступил
yielding|уступающий
yields|урожайность
via|через
legislation|законодательство
legislations|законодательства
county|графство
counties|округа
unlike|в-отличие-от
mobile|мобильный
mobiles|мобильные-телефоны
assistant|помощник
assistants|помощники
implement|орудие
implemented|реализовано
implementing|реализация
implements|орудий
chart|диаграмма
charted|намеченный
charting|составление-графиков
charts|диаграммы
attach|прикрепить
attached|прикрепил
attaches|прикрепляет
attaching|присоединение
hell|ад
hells|ад
everywhere|везде
advise|советовать
advised|посоветовал
advises|советует
advising|консультирование
household|домашнее-хозяйство
households|домохозяйства
acknowledge|признать
acknowledged|признано
acknowledges|признает
acknowledging|признавая
reward|награда
rewarded|вознагражден
rewarding|вознаграждающий
rewards|награды
east|восток
hat|шляпа
hats|шляпы
hatted|в-шляпе
academic|академический
academics|академики
voter|избиратель
voters|избиратели
meanwhile|тем-временем
furthermore|кроме-того
accuse|обвинять
accused|обвиняемый
accuses|обвиняет
accusing|обвиняющий
scientific|научный
wage|заработная-плата
waged|велась
wages|заработная-плата
waging|ведение
absence|отсутствие
absences|отсутствия
construct|построить
constructed|построенный
constructing|построение
constructs|конструкции
remark|замечание
remarked|заметил
remarking|замечание
remarks|замечания
medicine|медицина
medicines|лекарства
professor|профессор
prof|проф
professors|профессора
rare|редкий
rarer|реже
rarest|редчайший
intention|намерение
intentions|намерения
dozen|дюжина
dozens|десятки
settlement|поселение
settlements|поселения
gap|разрыв
gapped|зазор
gapping|разрыв
gaps|пробелы
widely|широко
minimum|минимум
minima|минимумы
minimums|минимумы
northern|северный
estate|поместье
estates|поместья
equally|одинаково
expose|разоблачать
exposed|незащищенный
exposes|выставляет
exposing|разоблачение
alive|жив
shut|закрыто
shuts|закрывает
victory|победа
victories|победы
resolve|решимость
resolved|решено
resolves|решает
resolving|разрешение
critic|критик
critics|критики
variable|переменная
variables|переменные
enormous|огромный
sweet|сладкий
sweeter|слаще
sweetest|самый-сладкий
sweets|сладости
permanent|постоянный
emotion|эмоция
emotions|эмоции
pursue|преследовать
pursued|преследовали
pursues|преследует
pursuing|преследуя
tall|высокий
taller|выше
tallest|самый-высокий
urge|позыв
urged|призвал
urges|призывает
urging|призывая
enemy|враг
enemies|враги
appoint|назначать
appointed|назначен
appointing|назначающий
appoints|назначает
milk|молоко
milked|доили
milking|доение
milks|молоко
talent|талант
talented|талантливый
talents|таланты
smell|запах
smelled|пахло
smelling|обоняние
smells|запахи
prior|предшествующий
priors|априоры
priority|приоритет
priorities|приоритеты
online|онлайн
phrase|фраза
phrased|сформулированный
phrases|фразы
phrasing|фразировка
pilot|пилот
piloted|пилотируемый
piloting|пилотирование
pilots|пилоты
stable|конюшня
stabled|конюшня
stables|конюшни
stabling|конюшня
merely|просто
resolution|резолюция
resolutions|резолюции
communicate|общаться
communicated|сообщалось
communicates|общается
communicating|общение
injury|травма
injuries|травмы
vast|огромный
vaster|более-обширный
vastest|самый-большой
exhibition|выставка
exhibitions|выставки
producer|производитель
producers|производители
regional|региональный
regionals|регионалы
immediate|немедленно
incident|инцидент
incidents|инциденты
childhood|детство
childhoods|детство
draft|проект
drafted|составленный
drafting|составление
drafts|черновики
draught|черновик
draughts|шашки
slip|промах
slipped|поскользнулся
slipping|скольжение
slips|промахи
accompany|сопровождать
accompanied|сопровождаемый
accompanies|сопровождает
accompanying|сопровождающий
politician|политик
politicians|политики
angry|сердитый
angrier|злее
angriest|самый-злой
knock|стук
knocked|постучал
knocking|стук
knocks|стучит
seed|семя
seeded|посеянный
seeding|посев
seeds|семена
salary|зарплата
salaried|наемный
salaries|зарплаты
illustrate|иллюстрировать
illustrated|иллюстрированный
illustrates|иллюстрирует
illustrating|иллюстрирующий
imply|подразумевает
implied|подразумеваемый
implies|подразумевает
implying|подразумевая
breakfast|завтрак
breakfasted|позавтракал
breakfasting|завтрак
breakfasts|завтраки
temporary|временный
liberal|либерал
liberals|либералы
lake|озеро
lakes|озера
qualify|квалифицировать
qualified|квалифицированный
qualifies|квалифицируется
qualifying|квалификационный
competitive|конкурентный
truly|действительно
hi|привет
yellow|желтый
yellowed|пожелтевший
yellowing|пожелтение
yellows|желтые
habit|привычка
habited|обитаемый
habits|привычки
disk|диск
disc|диск
discs|диски
disks|диски
core|ядро
cored|сердцевина
cores|ядра
coring|отбор-керна
emotional|эмоциональный
aircraft|самолет
aircrafts|самолеты
self|сам
selves|себя
metal|металл
metals|металлы
existence|существование
existences|существования
bone|кость
boned|кости
bones|кости
boning|обвалка
panel|панель
paneled|панельный
paneling|обшивка-панелями
panelled|панельный
panelling|обшивка-панелями
panels|панели
prime|премьер
primed|загрунтованный
primes|простые-числа
priming|грунтовка
appointment|назначение
appointments|назначения
emphasize|подчеркнуть
emphasise|подчеркивать
emphasised|подчеркнул
emphasises|подчеркивает
emphasising|подчеркивая
emphasized|подчеркнул
emphasizes|подчеркивает
emphasizing|подчеркивая
maximum|максимум
effectively|эффективно
elsewhere|в-другом-месте
bother|беспокоить
bothered|обеспокоенный
bothering|беспокоить
bothers|беспокоит
initiative|инициатива
initiatives|инициативы
sharp|острый
sharper|острее
sharpest|самый-острый
diet|диета
dieted|соблюдал-диету
dieting|диета
diets|диеты
motion|движение
motioned|подал-знак
motioning|жестикуляция
motions|движения
gray|серый
grayed|посеревший
grayer|серее
grayest|самый-серый
graying|седение
grays|серые
grey|серый
greyed|посеревший
greyer|серее
greyest|самый-серый
greying|седеющий
greys|серые
plastic|пластик
plastics|пластмассы
complicate|усложнять
complicated|сложный
complicates|усложняет
complicating|усложняющий
discipline|дисциплина
disciplined|дисциплинированный
disciplines|дисциплины
disciplining|дисциплинирующий
disappoint|разочаровать
disappointed|расстроенный
disappointing|разочаровывающий
disappoints|разочаровывает
boss|босс
bossed|командовал
bosses|боссы
bossing|начальство
assumption|предположение
assumptions|предположения
freeze|заморозить
freezes|замерзает
freezing|замораживание
froze|застыл
frozen|замороженный
extreme|крайний
extremes|крайности
passage|проход
passages|проходы
reputation|репутация
reputations|репутации
forth|вперед
negotiation|переговоры
negotiations|переговоры
mechanism|механизм
mechanisms|механизмы
coat|пальто
coated|покрытый
coating|покрытие
coats|пальто
democracy|демократия
democracies|демократии
pocket|карман
pocketed|прикарманенный
pocketing|загребание
pockets|карманы
lucky|повезло
luckier|повезло-больше
luckiest|самый-удачливый
crash|крах
crashed|разбился
crashes|аварии
crashing|крах
observation|наблюдение
observations|наблюдения
meat|мясо
meats|мясо
concentration|концентрация
concentrations|концентрации
implication|импликация
implications|подразумеваемое
deserve|заслуживают
deserved|заслужил
deserves|заслуживает
deserving|заслуживающий
unusual|необычный
defend|защищать
defended|защищал
defending|защищающий
defends|защищает
classic|классика
classics|классика
king|король
kings|короли
interaction|взаимодействие
interactions|взаимодействия
repair|ремонт
repaired|отремонтированный
repairing|ремонт
repairs|ремонт
collapse|крах
collapsed|рухнул
collapses|рушится
collapsing|рушится
borrow|заимствовать
borrowed|заимствованный
borrowing|заимствование
borrows|занимает
fundamental|фундаментальный
fundamentals|основы
dish|блюдо
dished|тарелка
dishes|тарелки
dishing|мытье-посуды
abroad|за-границей
soul|душа
souls|души
capable|способный
defeat|поражение
defeated|побежденный
defeating|побеждая
defeats|поражения
presidential|президентский
perfectly|отлично
enhance|улучшить
enhanced|улучшенный
enhances|улучшает
enhancing|улучшение
proud|гордый
prouder|гордее
proudest|самый-гордый
emergency|чрезвычайное-положение
emergencies|чрезвычайные-ситуации
educational|образовательный
distinguish|различать
distinguished|выдающийся
distinguishes|отличает
distinguishing|различающий
substantial|существенный
nearby|рядом
manufacturer|производитель
manufacturers|производители
slide|слайд
slid|скользнул
slides|слайды
sliding|скольжение
valuable|ценный
valuables|ценности
personally|лично
breast|грудь
breasted|грудастый
breasting|грудное-вскармливание
breasts|грудь
cope|справиться
coped|справился
copes|справляется
coping|совладание
approximately|приблизительно
accommodation|размещение
accommodations|размещение
highlight|выделить
highlighted|выделено
highlighting|выделение
highlights|основные-моменты
reporter|репортер
reporters|репортеры
climate|климат
climates|климаты
shirt|рубашка
shirted|в-рубашке
shirting|рубашечный
shirts|рубашки
exception|исключение
exceptions|исключения
corporation|корпорация
corporations|корпорации
chip|чип
chipped|сколотый
chipping|сколы
chips|чипсы
winner|победитель
winners|победители
encounter|встреча
encountered|столкнулись
encountering|встречая
encounters|встречи
brown|коричневый
browned|подрумяненный
browner|коричневый
brownest|самый-коричневый
browning|подрумянивание
browns|коричневые
breathe|дышать
breathed|дышал
breathes|дышит
breathing|дыхание
excuse|оправдание
excused|извинился
excuses|оправдания
excusing|извиняющий
partly|частично
tennis|теннис
urban|городской
confuse|путать
confused|смущенный
confuses|сбивает-с-толку
confusing|запутанный
southern|южный
output|выход
outputs|выходы
outputted|выведено
outputting|вывод
beauty|красота
beauties|красавицы
massive|массивный
install|установить
installed|установлен
installing|установка
installs|устанавливает
calculate|рассчитать
calculated|рассчитано
calculates|вычисляет
calculating|расчет
mouse|мышь
mice|мыши
mouses|мыши
mathematics|математика
math|математика
maths|математика
upper|верхний
uppers|верх
creation|создание
creations|творения
occupy|оккупировать
occupied|занято
occupies|занимает
occupying|занимающий
outline|набросок
outlined|обрисованный-в-общих-чертах
outlines|очертания
outlining|изложение
sufficient|достаточно
update|обновление
updated|обновлено
updates|обновления
updating|обновление
luck|удача
lucked|повезло
lucking|удача
lucks|удачи
preserve|сохранить
preserved|сохранились
preserves|консервы
preserving|сохранение
split|раскол
splits|расколы
splitting|расщепление
swing|качели
swinging|качающийся
swings|качели
swung|качнулся
illness|болезнь
illnesses|болезни
journalist|журналист
journalists|журналисты
sudden|внезапный
advertisement|реклама
advertisements|реклама
consistent|последовательный
originally|изначально
aside|в-сторону
asides|отступления
comfort|комфорт
comforted|утешенный
comforting|утешительный
comforts|удобства
secondly|во-вторых
severe|суровый
severer|суровее
severest|суровый
gene|ген
genes|гены
prospect|перспектива
prospected|разведанный
prospecting|разведка
prospects|перспективы
snow|снег
snowed|выпал-снег
snowing|идет-снег
snows|снега
plot|сюжет
plots|участки
plotted|нанесенный-на-карту
plotting|заговор
neck|шея
necked|шея
necking|обниматься
necks|шеи
criterion|критерий
criterions|критерии
primarily|в-первую-очередь
integrate|интегрировать
integrated|интегрированный
integrates|интегрирует
integrating|интегрирующий
criticism|критика
criticisms|критика
convention|конвенция
conventions|конвенции
bet|ставка
bets|ставки
betted|поспорил
betting|ставки
retain|сохранить
retained|сохранено
retaining|сохраняя
retains|сохраняет
sequence|последовательность
sequenced|секвенированный
sequences|последовательности
sequencing|секвенирование
plain|равнина
plainer|проще
plainest|самый-простой
plains|равнины
volunteer|доброволец
volunteered|вызвался-добровольцем
volunteering|волонтерство
volunteers|волонтеры
rural|сельский
calm|спокойствие
calmed|успокоил
calmer|спокойнее
calmest|самый-спокойный
calming|успокаивающий
calms|успокаивает
abandon|отказаться
abandoned|заброшенный
abandoning|отказ
abandons|отказывается
examination|экзамен
examinations|экзамены
silence|тишина
silenced|замолчал
silences|тишина
silencing|заглушение
rapidly|быстро
efficient|эффективный
revolution|революция
revolutions|революции
delight|восторг
delighted|получивший-удовольствие
delighting|радующий
delights|наслаждения
spell|заклинание
spelled|пишется
spelling|написание
spells|заклинания
spelt|полба
premise|предпосылка
premised|предполагал
premises|помещение
premising|предпосылка
lean|постный
leaned|наклонился
leaner|более-стройный
leanest|худой
leaning|наклоняясь
leans|наклоняется
leant|наклонился
dramatic|драматический
dramatics|драматургия
differ|отличается
differed|отличались
differing|отличающиеся
differs|отличается
grateful|благодарный
protein|белок
proteins|белки
bike|велосипед
biked|ехал-на-велосипеде
bikes|велосипеды
biking|езда-на-велосипеде
distribute|распространять
distributed|распределенный
distributes|распределяет
distributing|распространение
intellectual|интеллектуал
intellectuals|интеллектуалы
derive|выводить
derived|полученный
derives|вытекает
deriving|выведение
crucial|решающий
unemployment|безработица
wheel|колесо
wheeled|колесный
wheeling|езда-на-велосипеде
wheels|колеса
crop|урожай
cropped|обрезанный
cropping|обрезка
crops|урожай
minority|меньшинство
minorities|меньшинства
origin|происхождение
origins|происхождение
interpretation|интерпретация
interpretations|интерпретации
gentleman|джентльмен
gentlemen|господа
drama|драма
dramas|драмы
landscape|пейзаж
landscaped|благоустроенный
landscapes|пейзажи
landscaping|озеленение
educate|просвещать
educated|образованный
educates|обучает
educating|обучающий
toy|игрушка
toyed|играл
toying|играющий
toys|игрушки
fault|ошибка
faulted|ошибочный
faulting|разлом
faults|недостатки
exhibit|выставка
exhibited|выставленный
exhibiting|выставлять
exhibits|экспонаты
minor|несовершеннолетний
minors|несовершеннолетние
hunt|охота
hunted|охотились
hunting|охота
hunts|охотится
storm|шторм
stormed|штурмовали
storming|штурм
storms|штормы
thick|толстый
thicker|толще
thickest|самый-толстый
achievement|достижение
achievements|достижения
negotiate|переговоры
negotiated|договорный
negotiates|ведет-переговоры
negotiating|ведение-переговоров
dominate|доминировать
dominated|доминировал
dominates|доминирует
dominating|доминирующий
supplier|поставщик
suppliers|поставщики
prize|премия
prized|ценится
prizes|призы
typically|типично
peer|сверстник
peered|заглянул
peering|вглядываясь
peers|сверстники
pension|пенсия
pensioned|на-пенсии
pensioning|пенсионный
pensions|пенсии
wing|крыло
winged|крылатый
winging|крылатый
wings|крылья
acquisition|приобретение
acquisitions|приобретения
laughter|смех
deeply|глубоко
recognition|признание
recognitions|признания
electricity|электричество
assistance|помощь
assistances|помощь
roof|крыша
roofed|крытый
roofing|кровля
roofs|крыши
retirement|выход-на-пенсию
retirements|выходы-на-пенсию
respectively|соответственно
variation|вариация
variations|вариации
ultimately|в-конечном-итоге
proof|доказательство
proofed|проверено
proofing|расстойка
proofs|доказательства
soil|почва
soiled|грязный
soiling|загрязнение
soils|почвы
smart|умный
smarted|умилился
smarter|умнее
smartest|самый-умный
smarting|жжение
smarts|умы
layer|слой
layered|слоистый
layering|наслоение
layers|слои
upset|расстроен
upsets|расстраивает
upsetting|расстраивает
tooth|зуб
teeth|зубы
toothed|зубчатый
representation|представление
representations|представления
preparation|подготовка
preparations|препараты
dispute|спор
disputed|спорный
disputes|споры
disputing|спорить
agenda|повестка-дня
agendas|повестки-дня
emphasis|акцент
emphases|акценты
edition|издание
editions|издания
silver|серебро
silvered|посеребренный
silvers|серебра
entertainment|развлечения
entertainments|развлечения
honest|честный
undertake|предпринять
undertaken|предпринято
undertakes|обязуется
undertaking|предприятие
undertakings|предприятия
undertook|предпринял
retail|розничная-торговля
retailed|продается-в-розницу
retailing|розничная-торговля
retails|розничная-торговля
wire|провод
wired|проводной
wires|провода
wiring|проводка
unlikely|маловероятно
unlikelier|маловероятнее
unlikeliest|самый-маловероятный
gay|гей
gayer|гейер
gayest|самый-гейский
gays|геи
publication|публикация
publications|публикации
slight|небольшой
slighted|пренебрег
slighter|слабее
slightest|малейший
slighting|пренебрежение
slights|пренебрежение
unknown|неизвестно
unknowns|неизвестные
framework|каркас
frameworks|фреймворки
zone|зона
zoned|зонированный
zones|зоны
zoning|зонирование
restrict|ограничить
restricted|ограниченный
restricting|ограничивающий
restricts|ограничивает
trace|след
traced|прослеживается
traces|следы
tracing|трассировка
inch|дюйм
inched|дюйм
inches|дюймы
inching|дюйм
equivalent|эквивалент
equivalents|эквиваленты
solid|твердый
solids|твердые-частицы
enterprise|предприятие
enterprises|предприятия
enterprising|предприимчивый
elderly|пожилые
owe|должен
owed|задолжал
owes|должен
owing|из-за
governor|губернатор
governors|губернаторы
uniform|униформа
uniformed|в-форме
uniforms|униформа
port|порт
ported|портированный
porting|портирование
ports|порты
pitch|шаг
pitched|разбил
pitches|смолы
pitching|качка
arrival|прибытие
arrivals|Прибытие
contemporary|современный
contemporaries|современники
gate|ворота
gated|закрытый
gates|ворота
gating|стробирование
ease|легкость
eased|облегченный
eases|облегчает
easing|ослабление
beer|пиво
beers|пиво
specialist|специалист
specialists|специалисты
assure|гарантировать
assured|уверен
assures|уверяет
assuring|заверяя
profile|профиль
profiled|профилированный
profiles|профили
profiling|профилирование
mood|настроение
moods|настроения
episode|эпизод
episodes|эпизоды
crack|трещина
cracked|треснувший
cracking|растрескивание
cracks|трещины
numerous|многочисленные
submit|отправить
submits|представляет
submitted|поданный
submitting|отправка
symptom|симптом
symptoms|симптомы
virtually|практически
era|эра
eras|эпохи
coverage|покрытие
tension|напряжение
tensioned|натянутый
tensioning|натяжение
tensions|напряженность
cable|кабель
cabled|кабельный
cables|кабели
cabling|прокладка-кабелей
sensitive|чувствительный
nervous|нервный
input|вход
inputs|входы
inputted|введено
inputting|ввод
isolate|изолировать
isolated|изолированный
isolates|изоляты
isolating|изолирующий
prisoner|заключенный
prisoners|заключенные
eliminate|устранить
eliminated|устранен
eliminates|устраняет
eliminating|устранение
tight|туго
tighter|плотнее
tightest|самый-плотный
wet|мокрый
wets|мочит
wetted|смочен
wetter|влажнее
wettest|самый-влажный
wetting|смачивание
secondary|вторичный
welfare|благосостояние
welfares|благосостояние
recruit|рекрут
recruited|набранный
recruiting|рекрутинг
recruits|новобранцы
exclude|исключить
excluded|исключено
excludes|исключает
excluding|исключая
string|строка
stringing|нанизывание
strings|струны
strung|натянутый
cloud|облако
clouded|облачный
clouding|помутнение
clouds|облака
persuade|убеждать
persuaded|убедил
persuades|убеждает
persuading|убеждающий
inspire|вдохновлять
inspired|вдохновленный
inspires|вдохновляет
inspiring|вдохновляющий
grand|большой
grander|грандиознее
grandest|величайший
hence|следовательно
crew|экипаж
crewed|экипаж
crewing|крюинг
crews|экипажи
phenomenon|явление
phenomena|явления
pupil|ученик
pupils|ученики
false|ложь
falser|лживее
falsest|самый-ложный
assist|помощь
assisted|помогал
assisting|помощь
assists|помогает
restore|восстановить
restored|восстановлено
restores|восстанавливает
restoring|восстановление
formula|формула
formulae|формулы
formulas|формулы
alter|изменить
altered|измененный
altering|изменение
alters|изменяет
perceive|воспринимать
perceived|воспринимается
perceives|воспринимает
perceiving|воспринимающий
routine|рутина
routines|рутины
sink|раковина
sank|затонул
sinking|тонущий
sinks|раковины
sunk|затонул
stare|смотреть
stared|уставился
stares|смотрит
staring|уставившись
anymore|больше
hero|герой
heroes|герои
supporter|сторонник
supporters|сторонники
convert|преобразовать
converted|преобразованный
converting|конвертация
converts|преобразует
steady|устойчивый
steadied|стабилизировался
steadier|более-устойчивый
steadies|стабилизирует
steadiest|самый-устойчивый
steadying|стабилизация
meter|метр
metered|измеренный
metering|измерение
meters|метров
metre|метр
metres|метров
truck|грузовик
trucked|грузовик
trucking|грузоперевозки
trucks|грузовики
nose|нос
nosed|носатый
noses|носы
nosing|обнюхивание
beside|рядом
sail|парус
sailed|плыл
sailing|парусный-спорт
sails|паруса
disaster|катастрофа
disasters|катастрофы
pace|темп
paced|темп
paces|шаги
pacing|стимуляция
heavily|тяжело
devote|посвящать
devoted|преданный
devotes|посвящает
devoting|посвящая
terrorist|террорист
terrorists|террористы
justify|оправдывать
justified|оправданный
justifies|оправдывает
justifying|оправдывающий
vital|жизненно-важный
vitals|жизненно-важные-органы
fascinate|очаровывать
fascinated|очарованный
fascinates|очаровывает
fascinating|очаровательный
external|внешний
externals|внешние
spare|запасной
spared|пощадили
sparer|запасной
spares|запчасти
sparest|самый-запасной
sparing|щадящий
whenever|всякий-раз,-когда
depression|депрессия
depressions|депрессии
guilty|виновен
guiltier|виновнее
guiltiest|виновнейший
underlie|лежать-в-основе
underlain|подложенный
underlies|лежит-в-основе
underlying|лежащий-в-основе
mom|мама
mommies|мамочки
mommy|мамочка
moms|мамы
distinction|различие
distinctions|различия
satisfaction|удовлетворение
satisfactions|удовлетворения
incorporate|включить
incorporated|включено
incorporates|включает-в-себя
incorporating|включение
pour|налить
poured|вылил
pouring|заливка
pours|наливает
sweep|развертка
sweeping|подметание
sweeps|зачистки
swept|подметенный
obligation|обязательство
obligations|обязательства
sir|сэр
evaluate|оценить
evaluated|оценено
evaluates|оценивает
evaluating|оценивая
anger|гнев
angered|разозлился
angers|злит
pub|паб
pubs|пабы
perception|восприятие
perceptions|восприятия
naturally|естественно
currency|валюта
currencies|валюты
database|база-данных
databases|базы-данных
initially|изначально
territory|территория
territories|территории
stream|поток
streamed|транслировалось
streaming|потоковое-вещание
streams|потоки
rarely|редко
height|высота
heights|высоты
apparent|кажущийся
western|западный
westerns|вестерны
expansion|расширение
expansions|расширения
constantly|постоянно
muscle|мышца
muscled|мускулистый
muscles|мышцы
scare|пугать
scared|испуганный
scares|пугает
scaring|пугающий
badly|плохо
everyday|каждый-день
boundary|граница
boundaries|границы
ratio|отношение
ratios|соотношения
essay|эссе
essayed|эссе
essaying|эссе
essays|эссе
scream|крик
screamed|закричал
screaming|кричать
screams|крики
withdraw|снять
withdrawing|снятие
withdrawn|снято
withdraws|отзывает
withdrew|снял
pollution|загрязнение
pollutions|загрязнения
disorder|расстройство
disordered|беспорядочный
disordering|разупорядочивание
disorders|расстройства
furniture|мебель
symbol|символ
symbols|символы
apartment|квартира
apartments|квартиры
demonstration|демонстрация
demonstrations|демонстрации
analyst|аналитик
analysts|аналитики
platform|платформа
platforms|платформы
steel|сталь
steeled|закаленный
steeling|закалка
steels|стали
cake|торт
caked|запекшийся
cakes|торты
caking|спекание
transform|трансформировать
transformed|трансформировался
transforming|трансформирующий
transforms|трансформирует
wound|рана
wounded|раненый
wounding|ранение
wounds|раны
restriction|ограничение
restrictions|ограничения
foundation|фундамент
foundations|фундаменты
designer|дизайнер
designers|дизайнеры
strain|штамм
strained|напряженный
straining|напрягая
strains|штаммы
innovation|инновация
innovations|инновации
album|альбом
albums|альбомы
singer|певец
singers|певцы
trail|тропа
trailed|прицепной
trailing|отстающий
trails|тропы
trap|ловушка
trapped|в-ловушке
trapping|отлов
trappings|атрибутика
traps|ловушки
loose|свободный
loosed|освобожденный
looser|слабее
looses|теряет
loosest|самый-свободный
loosing|проигрыш
extension|расширение
extensions|расширения
wealth|богатство
gradually|постепенно
tank|танк
tanked|танкованный
tanking|танкование
tanks|танки
evil|зло
eviler|злее
evilest|самый-злой
evils|зло
remarkable|замечательный
tune|мелодия
tuned|настроенный
tunes|мелодии
tuning|настройка
grass|трава
grassed|покрытый-травой
grasses|травы
grassing|травообразование
invitation|приглашение
invitations|приглашения
transition|переход
transitioned|перешел
transitioning|переход
transitions|переходы
frighten|пугать
frightened|испуганный
frightening|пугающий
frightens|пугает
bid|ставка
bade|велел
bidding|торги
bids|ставки
breed|порода
bred|выведенный
breeding|разведение
breeds|породы
extraordinary|чрезвычайный
brilliant|блестящий
adviser|советник
advisers|советники
stem|стебель
stemmed|выдержанный
stemming|стемминг
stems|стебли
reverse|обратный
reversed|перевернутый
reverses|переворачивает
reversing|реверсирование
mode|режим
modes|режимы
mirror|зеркало
mirrored|зеркальный
mirroring|зеркалирование
mirrors|зеркала
awful|ужасно
pose|поза
posed|позировал
poses|позы
posing|позирование
adjust|настроить
adjusted|скорректировано
adjusting|регулировка
adjusts|регулирует
creative|творческий
nowadays|в-настоящее-время
poem|стихотворение
poems|стихи
agricultural|сельскохозяйственный
competitor|конкурент
competitors|конкуренты
alcohol|алкоголь
alcohols|спирты
festival|фестиваль
festivals|фестивали
vegetable|овощ
vegetables|овощи
van|фургон
vans|фургоны
confident|уверенный
planet|планета
planets|планеты
curve|кривая
curved|изогнутый
curves|кривые
curving|изгибающийся
knee|колено
kneed|коленопреклоненный
kneeing|коленопреклонение
knees|колени
overcome|преодолеть
overcame|преодолел
overcomes|преодолевает
overcoming|преодоление
web|веб
webbed|перепончатый
webbing|лямки
webs|паутины
depth|глубина
depths|глубины
entrance|вход
entranced|очарованный
entrances|входы
entrancing|завораживающий
log|журнал
logged|зарегистрирован
logging|ведение-журнала
logs|журналы
giant|гигант
giants|гиганты
god|бог
gods|боги
portion|часть
portioned|порционный
portioning|порционирование
portions|порции
substance|вещество
substances|вещества
extensive|обширный
interpret|интерпретировать
interpreted|интерпретировал
interpreting|интерпретация
interprets|интерпретирует
independence|независимость
sugar|сахар
sugared|засахаренный
sugars|сахара
inner|внутренний
inners|внутренности
harm|вред
harmed|пострадал
harming|вредящий
harms|вредит
consult|проконсультироваться
consulted|консультировался
consulting|консалтинг
consults|консультирует
pink|розовый
pinked|розоватый
pinker|розовее
pinkest|самый-розовый
pinking|розоветь
pinks|розовые
shadow|тень
shadows|тени
strip|полоса
stripped|раздетый
stripping|зачистка
strips|полоски
smooth|гладкий
smoothed|сглаженный
smoother|более-гладкий
smoothest|самый-гладкий
smoothing|сглаживание
intervention|вмешательство
interventions|вмешательства
impress|впечатление
impressed|впечатленный
impresses|впечатляет
impressing|впечатляющий
exam|экзамен
exams|экзамены
vice|порок
vices|пороки
radical|радикальный
radicals|радикалы
similarly|аналогично
behave|вести-себя
behaved|вел-себя
behaves|ведет-себя
behaving|ведет-себя
loud|громко
louder|громче
loudest|самый-громкий
dimension|измерение
dimensioned|размерный
dimensioning|определение-размеров
dimensions|размеры
subsequent|последующий
infection|инфекция
infections|инфекции
jacket|куртка
jackets|куртки
efficiency|эффективность
efficiencies|эффективность
dirty|грязный
dirtied|испачканный
dirtier|грязнее
dirties|грязь
dirtiest|самый-грязный
dirtying|пачкание
statistic|статистика
statistics|статистика
regularly|регулярно
resort|курорт
resorted|прибегнул
resorting|прибегать
resorts|курорты
iron|железо
ironed|поглаженный
ironing|глажка
irons|утюги
broadcast|трансляция
broadcasted|транслировалось
broadcasting|вещание
broadcasts|трансляции
membership|членство
memberships|членство
bread|хлеб
breaded|панированный
breading|панировка
breads|хлеб
blind|слепой
blinded|ослепленный
blinder|слепец
blindest|самый-слепой
blinding|ослепляющий
blinds|жалюзи
pure|чистый
purer|чище
purest|чистейший
bloody|кровавый
bloodied|окровавленный
bloodier|кровавее
bloodies|кровавые
bloodiest|самый-кровавый
bloodying|кровавый
ally|союзник
allied|союзный
allies|союзники
quantity|количество
quantities|количества
bend|изгиб
bended|согнутый
bending|изгиб
bends|изгибы
bent|согнутый
mature|зрелый
matured|созрел
matures|созревает
maturing|созревание
briefly|кратко
alarm|сигнализация
alarmed|встревоженный
alarming|тревожный
alarms|будильники
disturb|беспокоить
disturbed|нарушенный
disturbing|тревожный
disturbs|беспокоит
sustain|поддерживать
sustained|устойчивый
sustaining|поддержание
sustains|поддерживает
flood|наводнение
flooded|затопленный
flooding|наводнение
floods|наводнения
poverty|бедность
crazy|сумасшедший
crazier|безумнее
crazies|психи
craziest|самый-сумасшедший
cite|цитата
cited|цитируется
cites|цитирует
citing|цитируя
newly|недавно
parallel|параллель
paralleled|параллельно
paralleling|параллелизм
parallels|параллели
gender|пол
gendered|гендерный
genders|гендеры
sponsor|спонсор
sponsored|спонсируемый
sponsoring|спонсирование
sponsors|спонсоры
boot|ботинок
booted|загрузился
booting|загрузка
boots|сапоги
accurate|точный
dealer|дилер
dealers|дилеры
button|кнопка
buttoned|застегнутый
buttoning|застегивание-пуговиц
buttons|кнопки
burden|бремя
burdened|обремененный
burdening|обременение
burdens|бремя
desert|пустыня
deserted|заброшенный
deserting|дезертирство
deserts|пустыни
mate|приятель
mated|повязанный
mates|приятели
mating|спаривание
occasionally|иногда
shareholder|акционер
shareholders|акционеры
bowl|чаша
bowled|подан
bowling|боулинг
bowls|миски
discovery|открытие
discoveries|открытия
resistance|сопротивление
resistances|сопротивления
bath|ванна
baths|ванны
frequency|частота
frequencies|частоты
criticize|критиковать
criticise|критиковать
criticised|критиковали
criticises|критикует
criticising|критикуя
criticized|критиковали
criticizes|критикует
criticizing|критикуя
tap|кран
tapped|постучал
tapping|постукивание
taps|краны
philosophy|философия
philosophies|философии
lip|губа
lipped|губами
lips|губы
attribute|атрибут
attributed|приписано
attributes|атрибуты
attributing|приписывая
apologize|извиниться
apologise|извиняться
apologised|извинился
apologises|извиняется
apologising|извиняясь
apologized|извинился
apologizes|извиняется
apologizing|извиняясь
approval|одобрение
approvals|утверждения
grab|хватать
grabbed|схватил
grabbing|хватание
grabs|хватает
entitle|давать-право
entitled|уполномоченный
entitles|дает-право
entitling|дающий-право
lend|одолжить
lending|кредитование
lends|одалживает
lent|одолжил
involvement|участие
involvements|вовлеченности
exposure|воздействие
exposures|экспозиции
conventional|обычный
digital|цифровой
digitals|цифровые
translate|перевести
translated|переведено
translates|переводит
translating|перевод
edit|редактировать
edited|отредактировано
editing|редактирование
edits|правки
formation|формирование
formations|образования
deposit|депозит
deposited|депонированный
depositing|депонирование
deposits|депозиты
pleasant|приятный
pleasanter|приятнее
pleasantest|самый-приятный
overseas|за-рубежом
oversea|заморский
advocate|защитник
advocated|отстаивал
advocates|адвокаты
advocating|выступая-за
establishment|учреждение
establishments|учреждения
summary|резюме
summaries|резюме
rough|грубый
roughed|грубый
rougher|грубее
roughest|грубейший
roughing|черновая-обработка
roughs|грубости
pen|ручка
penned|написал
penning|пеннинг
pens|ручки
recovery|восстановление
recoveries|восстановления
seal|печать
sealed|запечатанный
sealing|герметизация
seals|уплотнения
tube|трубка
tubed|трубчатый
tubes|трубки
tubing|трубка
tower|башня
towered|возвышался
towering|возвышающийся
towers|башни
characterize|характеризовать
characterise|характеризовать
characterised|охарактеризованный
characterises|характеризует
characterising|характеризующий
characterized|характеризуется
characterizes|характеризует
characterizing|характеризующий
specify|указать
specified|указанный
specifies|указывает
specifying|указание
exact|точно
exacted|взысканный
exacting|требовательный
exacts|взимает
spin|спин
spinning|спиннинг
spins|спины
spun|пряли
operator|оператор
operators|операторы
infant|младенец
infants|младенцы
dig|копать
digging|копать
digs|раскопки
dug|вырыли
drag|перетаскивание
dragged|тащили
dragging|перетаскивание
drags|тащит
mount|крепление
mounted|смонтированный
mounting|монтаж
mounts|монтирует
wrap|обертывание
wrapped|завернутый
wrapping|упаковка
wraps|обертывания
anticipate|предвидеть
anticipated|ожидаемый
anticipates|предвидит
anticipating|предвкушая
dependent|зависимый
dependents|иждивенцы
specialize|специализироваться
specialise|специализироваться
specialised|специализированный
specialises|специализируется
specialising|специализирующийся
specialized|специализированный
specializes|специализируется
specializing|специализирующийся
angle|угол
angled|угловой
angles|углы
angling|рыбалка
chicken|курица
chickened|струсил
chickens|куры
anxiety|беспокойство
anxieties|тревоги
virus|вирус
viruses|вирусы
precisely|точно
rival|соперник
rivaled|соперничал
rivaling|соперничающий
rivalled|соперничал
rivalling|соперничающий
rivals|соперники
offense|правонарушение
offence|правонарушение
offences|правонарушения
offenses|правонарушения
detect|обнаружить
detected|обнаружен
detecting|обнаружение
detects|обнаруживает
teenager|подросток
teenagers|подростки
admire|восхищаюсь
admired|восхищался
admires|восхищается
admiring|восхищаясь
moderate|умеренный
moderated|модерируемый
moderates|умеренные
moderating|модерирование
surgery|операция
surgeries|операции
musician|музыкант
musicians|музыканты
significance|значение
significances|значения
shower|душ
showered|принял-душ
showering|душ
showers|ливни
illegal|незаконный
charity|благотворительность
charities|благотворительные-организации
universal|универсальный
universals|универсалии
cigarette|сигарета
cigarettes|сигареты
constitute|составляют
constituted|составил
constitutes|составляет
constituting|составляющий
adequate|адекватный
consultant|консультант
consultants|консультанты
historian|историк
historians|историки
cousin|кузен
cousins|кузены
visual|визуальный
visuals|визуальные-эффекты
stupid|глупый
stupider|глупее
stupidest|глупейший
keen|острый
keened|заостренный
keener|острее
keenest|самый-острый
keening|причитание
keens|любит
ethnic|этнический
ethnics|этника
twin|близнец
twins|двойняшки
clinical|клинический
eastern|восточный
forecast|прогноз
forecasted|прогнозируемый
forecasting|прогнозирование
forecasts|прогнозы
segment|сегмент
segmented|сегментированный
segmenting|сегментация
segments|сегменты
custom|обычай
customs|таможня
adapt|адаптировать
adapted|адаптированный
adapting|адаптация
adapts|адаптируется
sand|песок
sanded|отшлифованный
sanding|шлифовка
sands|пески
cap|колпачок
capped|ограниченный
capping|укупорка
caps|крышки
prompt|подсказка
prompted|подсказал
prompting|побуждение
prompts|подсказки
charm|очарование
charmed|Зачарованные
charming|очаровательный
charms|прелести
react|реагировать
reacted|отреагировал
reacting|реагирующий
reacts|реагирует
lecture|лекция
lectured|читал-лекции
lectures|лекции
lecturing|чтение-лекций
venture|предприятие
ventured|рискнул
ventures|предприятия
venturing|рисковать
compound|соединение
compounded|усугубленный
compounds|соединения
rescue|спасение
rescued|спасён
rescues|спасает
rescuing|спасение
mess|беспорядок
messed|испорченный
messes|беспорядок
messing|возиться
preference|предпочтение
preferences|предпочтения
comprehensive|всеобъемлющий
incentive|стимул
incentives|стимулы
league|лига
leagues|лиги
dialog|диалог
dialoged|диалоговый
dialoging|диалог
dialogs|диалоги
dialogue|диалог
dialogued|диалоговый
dialogues|диалоги
dialoguing|диалог
cream|крем
creamed|взбитый
creaming|взбивание
creams|кремы
rapid|быстрый
cancel|отменить
canceled|отменено
canceling|отмена
cancelled|отменено
cancelling|отмена
cancels|отменяет
regret|сожаление
regrets|сожаления
regretted|сожалел
regretting|сожалея
dismiss|уволить
dismissed|уволен
dismisses|отклоняет
dismissing|увольнение
margin|маржа
margins|поля
beneath|ниже
opponent|противник
opponents|противники
resist|сопротивляться
resisted|сопротивлялся
resisting|сопротивление
resists|сопротивляется
capability|способность
capabilities|возможности
absolute|абсолютный
absolutes|абсолюты
correspond|соответствовать
corresponded|переписывался
corresponding|соответствующий
corresponds|соответствует
stroke|инсульт
stroked|погладил
strokes|инсульты
stroking|поглаживание
dare|дерзай
dared|посмел
dares|осмеливается
daring|смелый
barrier|барьер
barriers|барьеры
rid|избавиться
ridded|избавился
ridding|избавление
rids|избавляет
divorce|развод
divorced|в-разводе
divorces|разводы
divorcing|развод
ruin|крушение
ruined|разрушенный
ruining|губить
ruins|руины
bury|хоронить
buried|похороненный
buries|хоронит
burying|хоронить
counsel|адвокат
counseled|консультировал
counseling|консультирование
counselled|консультировал
counselling|консультирование
counsels|советы
tendency|тенденция
tendencies|тенденции
frequent|частый
frequented|часто-посещаемый
frequenting|частое-посещение
frequents|частые
motor|мотор
motored|моторизованный
motoring|автомобилизм
motors|моторы
survival|выживание
survivals|выживаний
counter|счетчик
countered|противопоставленный
countering|противодействие
counters|счетчики
possess|обладать
possessed|одержимый
possesses|обладает
possessing|обладающий
permission|разрешение
permissions|разрешения
valley|долина
valleys|долины
float|поплавок
floated|плавал
floating|плавающий
floats|плавает
mad|безумный
madder|марена
maddest|безумнейший
greatly|очень
visible|видимый
electric|электрический
electrics|электрика
impressive|впечатляет
evolution|эволюция
evolutions|эволюции
awareness|осознание
violent|жестокий
slave|раб
slaved|рабский
slaves|рабы
slaving|рабство
wealthy|богатый
wealthier|богаче
wealthiest|самый-богатый
architecture|архитектура
architectures|архитектуры
acceptable|приемлемо
journal|журнал
journaling|ведение-журнала
journals|журналы
coal|уголь
coals|угли
measurement|измерение
measurements|измерения
random|случайный
successfully|успешно
depress|депрессия
depressed|подавленный
depresses|угнетает
depressing|удручающий
illustration|иллюстрация
illustrations|иллюстрации
burst|взрыв
bursting|разрывной
bursts|всплески
privilege|привилегия
privileged|привилегированный
privileges|привилегии
privileging|привилегированный
buyer|покупатель
buyers|покупатели
mutual|взаимный
rail|рельс
railed|оградил
railing|перила
railings|перила
rails|рельсы
motivate|мотивировать
motivated|мотивированный
motivates|мотивирует
motivating|мотивирующий
laboratory|лаборатория
laboratories|лаборатории
mortgage|ипотека
mortgaged|заложенный
mortgages|ипотечные-кредиты
promotion|продвижение
promotions|акции
passion|страсть
passions|страсти
champion|чемпион
championed|отстаивал
championing|отстаивание
champions|чемпионы
fulfill|выполнить
fulfil|выполнить
fulfiled|выполнено
fulfiling|выполняющий
fulfilled|выполнено
fulfilling|выполняющий
fulfills|выполняет
fulfils|выполняет
dust|пыль
dusted|посыпанный-пылью
dusting|пыление
dusts|пыли
dedicate|посвящать
dedicated|преданный
dedicates|посвящает
dedicating|посвящая
roughly|примерно
skirt|юбка
skirted|облегающий
skirting|плинтус
skirts|юбки
province|провинция
provinces|провинции
march|март
marched|маршировали
marches|марши
marching|марширующий
evaluation|оценка
evaluations|оценки
compromise|компромисс
compromised|скомпрометирован
compromises|компромиссы
compromising|компрометирующий
accomplish|выполнить
accomplished|удавшийся
accomplishes|достигает
accomplishing|достижение
weakness|слабость
weaknesses|слабости
announcement|объявление
announcements|объявления
salt|соль
salted|соленый
salting|соление
salts|соли
glance|взгляд
glanced|взглянул
glances|взгляды
glancing|поглядывая
opera|опера
operas|оперы
contest|конкурс
contested|оспариваемый
contesting|оспаривание
contests|конкурсы
brush|кисть
brushed|почищенный
brushes|кисти
brushing|чистка-зубов
embarrass|смущать
embarrassed|смущенный
embarrasses|смущает
embarrassing|смущающий
gallery|галерея
galleries|галереи
genetic|генетический
aggressive|агрессивный
chest|грудь
chests|сундуки
format|формат
formats|форматы
formatted|отформатированный
formatting|форматирование
literary|литературный
govern|управлять
governed|управляемый
governing|управляющий
governs|управляет
embrace|объятия
embraced|обнял
embraces|объятия
embracing|охватывающий
praise|похвала
praised|похвалил
praises|хвалит
praising|хвалить
silent|молчание
pump|насос
pumped|накачанный
pumping|насосный
pumps|насосы
publisher|издатель
publishers|издатели
celebration|празднование
celebrations|празднования
golf|гольф
compensation|компенсация
compensations|компенсации
classical|классический
weigh|весить
weighed|взвешенный
weighing|взвешивание
weighs|весит
versus|против
deficit|дефицит
deficits|дефициты
modify|изменить
modified|измененный
modifies|изменяет
modifying|модифицирующий
flash|вспышка
flashed|мелькнуло
flashes|вспышки
flashing|мигает
friendship|дружба
friendships|дружба
profession|профессия
professions|профессии
literally|буквально
equation|уравнение
equations|уравнения
gesture|жест
gestured|жестикулировал
gestures|жесты
gesturing|жестикулируя
entertain|развлекать
entertained|развлекали
entertaining|развлекательный
entertains|развлекает
fantastic|фантастика
assign|назначить
assigned|назначенный
assigning|назначение
assigns|присваивает
inflation|инфляция
inflations|инфляции
historic|исторический
injure|ранить
injured|раненый
injures|ранит
injuring|ранение
remote|удаленный
remoter|удаленнее
remotest|самый-отдаленный
therapy|терапия
therapies|терапии
orange|оранжевый
oranges|апельсины
twist|твист
twisted|скрученный
twisting|скручивание
twists|повороты
personnel|персонал
imagination|воображение
imaginations|воображение
disagree|не-согласен
disagreed|не-согласился
disagreeing|несогласный
disagrees|не-согласен
throat|горло
throats|глотки
insight|понимание
insights|идеи
tackle|снасть
tackled|решено
tackles|снасти
tackling|борьба
forever|навсегда
exceed|превышать
exceeded|превышен
exceeding|превышающий
exceeds|превышает
expenditure|расходы
expenditures|расходы
joy|радость
joys|радости
pregnant|беременная
reliable|надежный
reliables|надежные
gear|передача
geared|редукторный
gearing|передача
gears|шестерни
poet|поэт
poets|поэты
fortune|удача
fortunes|состояния
ceremony|церемония
ceremonies|церемонии
pile|куча
piled|сложенный
piles|сваи
piling|укладка
pig|свинья
pigged|свиной
pigging|свиноводство
pigs|свиньи
mixture|смесь
mixtures|смеси
automatically|автоматически
scholar|ученый
scholars|ученые
psychological|психологический
dramatically|драматически
stake|кол
staked|поставленный-на-карту
stakes|ставки
staking|ставка
creature|существо
creatures|существа
partnership|партнерство
partnerships|партнерства
participation|участие
participations|участия
clause|пункт
clauses|пункты
penalty|штраф
penalties|штрафы
chamber|камера
chambered|камерный
chambering|досылание
chambers|палаты
fancy|фантазия
fancied|воображаемый
fancies|фантазии
fanciest|самый-причудливый
fancying|воображая
poetry|поэзия
poetries|поэзия
chat|чат
chats|чаты
chatted|болтали
chatting|чат
clothing|одежда
evolve|эволюционировать
evolved|эволюционировал
evolves|развивается
evolving|развивающийся
sake|сакэ
sakes|сакэ
shelf|полка
shelved|отложенный
shelves|полки
shelving|стеллажи
boost|усиление
boosted|усиленный
boosting|повышение
boosts|повышает
tail|хвост
tailed|хвостатый
tailing|хвостохранилище
tails|хвосты
possession|владение
possessions|имущество
abortion|аборт
abortions|аборты
curious|любопытный
curiouser|любопытнее
wooden|деревянный
boom|бум
boomed|прогремел
booming|процветающий
booms|бумы
tale|сказка
tales|сказки
democratic|демократический
maintenance|обслуживание
maintenances|техническое-обслуживание
consequently|следовательно
pot|горшок
pots|горшки
potted|в-горшке
potting|горшечная-рассада
cow|корова
cowed|запуганный
cowing|устрашение
cows|коровы
strengthen|укреплять
strengthened|укрепленный
strengthening|укрепление
strengthens|укрепляет
whilst|пока
constraint|ограничение
constraints|ограничения
fold|сгиб
folded|сложенный
folding|складной
folds|складки
bin|мусорное-ведро
binned|отправлено-в-корзину
binning|биннинг
bins|мусорные-баки
undergo|подвергаться
undergoes|подвергается
undergoing|претерпевает
undergone|подвергся
underwent|подвергся
potentially|потенциально
scope|область-применения
scoped|область-действия
scopes|области-применения
scoping|область-действия
pretend|притворяться
pretended|притворился
pretending|притворяясь
pretends|притворяется
diversity|разнообразие
diversities|разнообразие
allege|утверждать
alleged|предполагаемый
alleges|утверждает
pride|гордость
prided|гордился
prides|гордится
priding|гордый
intense|интенсивный
inquiry|запрос
inquiries|запросы
resign|уйти-в-отставку
resigned|ушел-в-отставку
resigning|уходящий-в-отставку
resigns|уходит-в-отставку
craft|ремесло
crafted|созданный
crafting|крафтить
crafts|ремесла
strict|строгий
stricter|строже
strictest|строжайший
concrete|бетон
concreted|забетонированный
concretes|бетоны
concreting|бетонирование
shell|ракушка
shelled|очищенный
shells|ракушки
damn|черт
damned|проклятый
damning|осуждающий
damns|черт
distinct|отчетливый
humor|юмор
humored|юмористический
humoring|юмористический
humors|юморы
humour|юмор
humoured|юмористический
humours|юмор
limitation|ограничение
limitations|ограничения
indication|указание
indications|показания
stability|стабильность
stabilities|стабильности
wise|мудрый
wised|мудрый
wiser|мудрее
wises|мудрые
wisest|мудрейший
wising|мудрый
neglect|пренебрежение
neglected|пренебречь
neglecting|пренебрегая
neglects|пренебрегает
compose|сочинять
composed|составленный
composes|сочиняет
composing|сочинение
jail|тюрьма
jailed|заключен-в-тюрьму
jailing|заключение-в-тюрьму
jails|тюрьмы
shelter|убежище
sheltered|защищенный
shelters|приюты
mere|просто
merest|самый
carbon|углерод
carbons|углероды
regulate|регулировать
regulated|регулируется
regulates|регулирует
regulating|регулирующий
cheese|сыр
cheeses|сыры
trigger|триггер
triggered|сработал
triggering|запуск
triggers|триггеры
pipe|труба
piped|трубчатый
pipes|трубы
piping|трубопровод
destruction|разрушение
destructions|разрушения
guitar|гитара
guitars|гитары
flag|флаг
flagged|помечено
flagging|пометка
flags|флаги
piano|фортепиано
pianos|пианино
magic|магия
mystery|тайна
mysteries|тайны
ski|лыжи
skied|катался-на-лыжах
skiing|катание-на-лыжах
skis|лыжи
whisper|шепот
whispered|прошептал
whispering|шепот
whispers|шепот
rear|задний
reared|воспитанный
rearing|выращивание
rears|тылы
menu|меню
menus|меню
species|вид
moon|луна
mooned|лунный
moons|луны
presumably|предположительно
bless|благословить
blessed|благословенный
blesses|благословляет
blessing|благословение
blessings|благословения
blest|благословенный
airline|авиакомпания
airlines|авиакомпании
amendment|поправка
amendments|поправки
grandmother|бабушка
grandmothers|бабушки
jury|жюри
juries|присяжные
cooperation|сотрудничество
civilian|гражданский
civilians|гражданские-лица
composition|состав
compositions|композиции
coin|монета
coined|придуманный
coining|чеканка
coins|монеты
regardless|независимо
scan|сканирование
scanned|сканированный
scanning|сканирование
scans|сканирует
bunch|пучок
bunched|сгруппированный
bunches|пучки
bunching|группировка
racial|расовый
racials|расовые
greet|приветствовать
greeted|поприветствовал
greeting|приветствие
greetings|привет
greets|приветствует
hopefully|надеюсь
sanction|санкция
sanctioned|санкционированный
sanctioning|санкционирование
sanctions|санкции
trick|трюк
tricked|обманутый
tricking|обман
tricks|трюки
paragraph|абзац
paragraphed|параграфированный
paragraphing|абзацы
paragraphs|абзацы
maker|производитель
makers|производители
chocolate|шоколад
chocolates|шоколадки
stimulate|стимулировать
stimulated|стимулировал
stimulates|стимулирует
stimulating|стимулирующий
belt|пояс
belted|опоясанный
belting|ременная-передача
belts|ремни
potato|картофель
potatoes|картофель
narrative|повествование
narratives|повествования
tissue|ткань
tissues|ткани
barely|едва
invent|изобрести
invented|изобретенный
inventing|изобретение
invents|изобретает
tourism|туризм
pro|про
pros|плюсы
stair|лестница
stairs|лестница
hesitate|колебаться
hesitated|колебался
hesitates|колеблется
hesitating|колеблющийся
shine|блеск
shined|сиял
shines|светит
shining|сияющий
shone|сиял
motivation|мотивация
motivations|мотивации
romantic|романтический
romantics|романтики
firmly|твердо
interior|интерьер
interiors|интерьеры
stomach|желудок
stomached|желудок
stomaching|переваривание
stomachs|желудки
nowhere|нигде
pray|молиться
prayed|молился
praying|молиться
prays|молится
championship|чемпионат
championships|чемпионаты
servant|слуга
servants|слуги
immigrant|иммигрант
immigrants|иммигранты
excess|избыток
excesses|излишества
complexity|сложность
complexities|сложности
liability|ответственность
liabilities|обязательства
surprisingly|удивительно
extract|выдержка
extracted|извлеченный
extracting|извлечение
extracts|экстракты
implementation|реализация
implementations|реализации
bias|предвзятость
biased|пристрастный
biases|предубеждения
biasing|предвзятость
differently|по-разному
catalog|каталог
cataloged|каталогизированный
cataloging|каталогизация
catalogs|каталоги
catalogue|каталог
catalogued|каталогизированный
catalogues|каталоги
cataloguing|каталогизация
continuous|непрерывный
golden|золотой
stamp|штамп
stamped|проштампованный
stamping|штамповка
stamps|марки
guideline|руководство
guidelines|руководящие-принципы
envelope|конверт
envelopes|конверты
knife|нож
knifed|зарезанный
knifes|ножи
knifing|ножевое-ранение
knives|ножи
biological|биологический
consume|потреблять
consumed|потребленный
consumes|потребляет
consuming|потребляющий
luxury|роскошь
luxuries|роскошь
weekly|еженедельно
weeklies|еженедельники
wherever|где-бы-то-ни-было
bite|укус
bites|укусы
biting|кусание
bitten|укушенный
printer|принтер
printers|принтеры
firstly|во-первых
anxious|тревожный
adventure|приключение
adventured|приключенческий
adventures|приключения
adventuring|приключения
fence|забор
fenced|огороженный
fences|заборы
fencing|фехтование
exhaust|выхлоп
exhausted|измученный
exhausting|изнурительный
exhausts|выхлопы
attraction|притяжение
attractions|достопримечательности
ocean|океан
oceans|океаны
quietly|тихо
castle|замок
castled|рокированный
castles|замки
castling|рокировка
veteran|ветеран
veterans|ветераны
reflection|отражение
reflections|размышления
nerve|нерв
nerved|нервный
nerves|нервы
nerving|нервирующий
determination|определение
determinations|определения
altogether|в-целом
fiction|вымысел
fictions|вымыслы
carpet|ковер
carpeted|ковровое-покрытие
carpeting|ковровое-покрытие
carpets|ковры
cluster|кластер
clustered|кластеризованный
clustering|кластеризация
clusters|кластеры
confusion|путаница
confusions|путаница
hurry|спешить
hurried|поспешил
hurries|спешит
hurrying|торопясь
logic|логика
logics|логики
controversial|спорный
raw|сырой
rawer|сырее
rawest|самый-сырой
grammar|грамматика
grammars|грамматики
revise|пересмотреть
revised|пересмотренный
revises|пересматривает
revising|пересмотр
hint|намек
hinted|намекнул
hinting|намекая
hints|намеки
hook|крючок
hooked|зацепился
hooking|зацепление
hooks|крючки
bell|колокол
belled|колокольчатый
belling|колокольчик
bells|колокола
liquid|жидкость
liquids|жидкости
panic|паника
panicked|запаниковал
panicking|паникующий
panics|паника
uncle|дядя
uncles|дяди
rice|рис
rices|рис
slope|наклон
slopes|склоны
happiness|счастье
genuine|подлинный
vessel|судно
vessels|сосуды
verb|глагол
verbs|глаголы
reckon|считать
reckoned|подсчитано
reckoning|расчёт
reckons|считает
silly|глупый
sillier|глупее
silliest|глупейший
transportation|транспорт
transportations|перевозки
harbor|гавань
harbored|укрывал
harboring|укрывательство
harbors|гавани
harbour|гавань
harbouring|укрывательство
harbours|гавани
comedy|комедия
comedies|комедии
chase|погоня
chased|преследовали
chases|погони
chasing|погоня
storage|хранение
storages|хранилища
universe|вселенная
universes|вселенные
horrible|ужасно
sheep|овца
lover|любовник
lovers|любовники
rat|крыса
rats|крысы
ratted|крысиный
ratting|рейтинг
portrait|портрет
portraits|портреты
innocent|невинный
innocents|невинные
substitute|замена
substituted|замененный
substitutes|заменители
substituting|заменяя
supplement|дополнение
supplemented|дополненный
supplementing|дополняющий
supplements|добавки
adjustment|регулировка
adjustments|корректировки
reasonably|разумно
filter|фильтр
filtered|отфильтровано
filtering|фильтрация
filters|фильтры
flexible|гибкий
abstract|аннотация
abstracted|абстрагированный
abstracting|абстрагирование
abstracts|рефераты
tent|палатка
tented|палаточный
tenting|палатка
tents|палатки
precise|точный
distant|далекий
stranger|незнакомец
strangers|незнакомцы
shade|оттенок
shaded|затененный
shades|оттенки
shading|затенение
grain|зерно
grained|зернистый
graining|зернистость
grains|зерна
situate|располагать
situated|расположен
situates|размещает
situating|располагающий
summarize|резюмировать
summarise|резюмировать
summarised|резюмировал
summarises|резюмирует
summarising|подведение-итогов
summarized|резюмировал
summarizes|резюмирует
summarizing|подведение-итогов
leap|прыжок
leaped|прыгнул
leaping|прыгающий
leaps|прыжки
leapt|прыгнул
snap|щелчок
snapped|щелкнул
snapping|щелчок
snaps|защелки
probability|вероятность
probabilities|вероятности
leather|кожа
leathered|кожаный
leathering|выделка-кожи
leathers|кожи
uncertainty|неопределенность
uncertainties|неопределенности
swear|ругаться
swearing|ругань
swears|ругается
swore|поклялся
sworn|присяжный
refugee|беженец
refugees|беженцы
shore|берег
shored|подпирал
shores|берега
shoring|подпорка
monthly|ежемесячно
comprise|включают-в-себя
comprised|состоял-из
comprises|включает-в-себя
comprising|включающий
stir|размешивать
stirred|перемешивают
stirring|перемешивание
stirrings|побуждения
stirs|шевелится
excitement|волнение
excitements|волнения
sigh|вздох
sighed|вздохнул
sighing|вздыхая
sighs|вздохи
pregnancy|беременность
pregnancies|беременности
experimental|экспериментальный
experimentals|эксперименты
institutional|институциональный
slice|ломтик
sliced|нарезанный
slices|ломтики
slicing|нарезка
wander|бродить
wandered|бродил
wandering|блуждающий
wanderings|странствия
wanders|бродит
empire|империя
empires|империи
subsequently|впоследствии
gentle|нежный
gentled|смягчённый
gentler|мягче
gentles|джентльмены
gentlest|нежнейший
gentling|смягчающий
attendance|посещаемость
attendances|посещаемость
ownership|собственность
ownerships|собственности
qualification|квалификация
qualifications|квалификации
suspend|приостановить
suspended|приостановленный
suspending|приостановка
suspends|приостанавливает
functional|функциональный
voluntary|добровольный
pale|бледный
paled|побледнел
paler|бледнее
pales|бледнеет
palest|бледнейший
paling|бледнеет
stain|пятно
stained|окрашенный
staining|окрашивание
stains|пятна
athlete|спортсмен
athletes|спортсмены
organic|органический
organics|органика
tongue|язык
tongued|наговоренный
tongues|языки
tonguing|язык
server|сервер
servers|серверы
structural|структурный
fool|дурак
fooled|обманутый
fooling|дурачество
fools|дураки
alongside|рядом
unite|объединяться
united|объединенный
unites|объединяет
uniting|объединяющий
gently|нежно
compute|вычислить
computed|вычисленный
computes|вычисляет
computing|вычисление
wipe|протирать
wiped|вытерто
wipes|салфетки
wiping|вытирание
weird|странный
weirder|страннее
weirdest|самый-странный
gaze|взгляд
gazed|смотрел
gazes|взгляды
gazing|пристально-глядя
fade|исчезать
faded|блеклый
fades|исчезает
fading|затухание
cough|кашель
coughed|кашлял
coughing|кашель
coughs|кашляет
hypothesis|гипотеза
hypotheses|гипотезы
royal|королевский
royals|королевская-семья
theoretical|теоретический
curtain|занавес
curtained|занавешенный
curtaining|занавеска
curtains|шторы
mayor|мэр
mayors|мэры
darkness|тьма
aunt|тетя
aunts|тети
tournament|турнир
tournaments|турниры
registration|регистрация
registrations|регистрации
fragment|фрагмент
fragmented|фрагментированный
fragmenting|фрагментация
fragments|фрагменты
listener|слушатель
listeners|слушатели
tender|нежный
tenders|тендеры
density|плотность
densities|плотности
ugly|уродливый
uglier|уродливее
ugliest|самый-уродливый
module|модуль
modules|модули
faithfully|добросовестно
autumn|осень
autumns|осени
cheek|щека
cheeked|щекастый
cheeks|щеки
attachment|вложение
attachments|вложения
holder|держатель
holders|держатели
grin|усмешка
grinned|ухмыльнулся
grinning|ухмыляясь
grins|ухмыляется
noun|существительное
nouns|существительные
fortunate|удачливый
alright|хорошо
lazy|ленивый
lazier|ленивее
laziest|ленивый
hello|привет
hunger|голод
hungered|голодный
hungering|голодный
hungers|голод
insure|страховать
insured|застрахованный
insures|страхует
insuring|страхование
ashamed|стыдно
found|найдено
founded|основан
founding|основание
founds|находит
thirst|жажда
thirsted|жаждал
thirsting|жаждущий
thirsts|жаждет
`;
